AAL	(Hindi) the Indian mulberry tree, aka noni, also AL [n -S]
AALS	AAL, (Hindi) the Indian mulberry tree, aka noni, also AL [n]
AARTI	(Hindi) an Indian ceremony in which candles dipped in ghee are lighted and offered to various deities, also ARTI [n -S]
AARTIS	AARTI, (Hindi) an Indian ceremony in which candles dipped in ghee are lighted and offered to various deities, also ARTI [n]
AATMAN	(Sanskrit) the essential self, also ATMA, ATMAN [n -S]
AATMANS	AATMAN, (Sanskrit) the essential self, also ATMA, ATMAN [n]
ACHAR	a spicy pickle made primarily from mango, used in Indian cooking [n -S]
ACHARS	ACHAR, a spicy pickle made primarily from mango, used in Indian cooking [n]
ACHARYA	(Sanskrit) a Hindu teacher or learned man [n -S]
ACHARYAS	ACHARYA, (Sanskrit) a Hindu teacher or learned man [n]
ACHKAN	(Hindi) in India, a knee-length coat with a high collar [n -S]
ACHKANS	ACHKAN, (Hindi) in India, a knee-length coat with a high collar [n]
ADHARMA	(Sanskrit) unrighteousness (the opposite of dharma) [n -S]
ADHARMAS	ADHARMA, (Sanskrit) unrighteousness (the opposite of dharma) [n]
AGILA	(Tamil) the wood of the aloe, aka agalwood [n -S]
AGILAS	AGILA, (Tamil) the wood of the aloe, aka agalwood [n]
AHIMSA	(Sanskrit) in Hindu philosophy, the principle of noninjury to living beings [n -S]
AHIMSAS	AHIMSA, (Sanskrit) in Hindu philosophy, the principle of noninjury to living beings [n]
AIA	(Hindi) in India, a maid or nurse, also AYAH [n -S]
AIAS	AIA, (Hindi) in India, a maid or nurse, also AYAH [n]
AJIVA	(Sanskrit) inanimate matter [n -S]
AJIVAS	AJIVA, (Sanskrit) inanimate matter [n]
AKHARA	(Hindi) a gymnasium [n -S]
AKHARAS	AKHARA, (Hindi) a gymnasium [n]
AL	(Hindi) the Indian mulberry tree, aka noni, also AAL [n -S]
ALAAP	(Sanskrit) in Indian music, the introductory section of a raga, also ALAP, ALAPA [n -S]
ALAAPS	ALAAP, (Sanskrit) in Indian music, the introductory section of a raga, also ALAP, ALAPA [n]
ALAP	(Sanskrit) in Indian music, the introductory section of a raga, also ALAAP, ALAPA [n -S]
ALAPA	(Sanskrit) in Indian music, the introductory section of a raga, also ALAAP, ALAP [n -S]
ALAPAS	ALAPA, (Sanskrit) in Indian music, the introductory section of a raga, also ALAAP, ALAP [n]
ALAPS	ALAP, (Sanskrit) in Indian music, the introductory section of a raga, also ALAAP, ALAPA [n]
ALMIRAH	(Hindi) a wardrobe, a chest of drawers [n -S]
ALMIRAHS	ALMIRAH, (Hindi) a wardrobe, a chest of drawers [n]
ALOO	(Hindi) a potato, also ALU [n -S]
ALOOS	ALOO, (Hindi) a potato, also ALU [n]
ALS	AL, (Hindi) the Indian mulberry tree, aka noni, also AAL [n]
ALU	(Hindi) a potato, also ALOO [n -S]
ALUS	ALU, (Hindi) a potato, also ALOO [n]
AMADAVAT	(Hindi) the strawberry finch, a small Indian song bird, commonly caged and kept for fighting, also AVADAVAT [n -S]
AMADAVATS	AMADAVAT, (Hindi) the strawberry finch, a small Indian song bird, commonly caged and kept for fighting, also AVADAVAT [n]
AMBARI	(Hindi) a fibre-yielding plant of East Indies, also AMBARY [n -S]
AMBARIES	AMBARY, (Hindi) a fibre-yielding plant of East Indies, also AMBARI [n]
AMBARIS	AMBARI, (Hindi) a fibre-yielding plant of East Indies, also AMBARY [n]
AMBARY	(Hindi) a fibre-yielding plant of East Indies, also AMBARI [n AMBARIES]
AMILDAR	(Urdu) a factor or manager in India, a collector of revenues, also AUMIL, AUMILDAR [n -S]
AMILDARS	AMILDAR, (Urdu) a factor or manager in India, a collector of revenues, also AUMIL, AUMILDAR [n]
AMLA	an East Indian tree [n -S]
AMLAS	AMLA, an East Indian tree [n]
AMREETA	(Sanskrit) a drink which bestows immortality in Hindu mythology, also AMRIT, AMRITA [n -S]
AMREETAS	AMREETA, (Sanskrit) a drink which bestows immortality in Hindu mythology, also AMRIT, AMRITA [n]
AMRIT	(Punjabi) a sacred sweetened water used in the Sikh baptismal ceremony, also AMREETA, AMRITA [n -S]
AMRITA	(Sanskrit) a beverage that bestows immortality in Hindu mythology, also AMRIT, AMREETA [n -S]
AMRITAS	AMRITA, (Sanskrit) a beverage that bestows immortality in Hindu mythology, also AMRIT, AMREETA [n]
AMRITATTVA	(Sanskrit) immortality [n -S]
AMRITATTVAS	AMRITATTVA, (Sanskrit) immortality [n]
AMRITATVA	(Sanskrit) a state of immortality [n -S]
AMRITATVAS	AMRITATVA, (Sanskrit) a state of immortality [n]
AMRITS	AMRIT, (Punjabi) a sacred sweetened water used in the Sikh baptismal ceremony, also AMREETA, AMRITA [n]
ANACONDA	(Sinhalese) a large S American snake [n -S]
ANACONDAS	ANACONDA, (Sinhalese) a large S American snake [n]
ANANDA	(Sanskrit) extreme happiness [n -S]
ANANDAS	ANANDA, (Sanskrit) extreme happiness [n]
ANATA	(Sanskrit) the Buddhist belief in the impermanence of self, also ANATMAN [n -S]
ANATAS	ANATA, (Sanskrit) the Buddhist belief in the impermanence of self, also ANATMAN [n]
ANATMAN	(Sanskrit) the Buddhist belief in the impermanence of self, also ANATA [n -S]
ANATMANS	ANATMAN, (Sanskrit) the Buddhist belief in the impermanence of self, also ANATA [n]
ANGA	(Sanskrit) any of the eight practises of yoga [n -S]
ANGANWADI	(Hindi) in India, a rural centre providing care for mothers and young children [n -S]
ANGANWADIS	ANGANWADI, (Hindi) in India, a rural centre providing care for mothers and young children [n]
ANGAS	ANGA, (Sanskrit) any of the eight practises of yoga [n]
ANICCA	(Sanskrit) the belief that everything is impermanent and constantly changing [n -S]
ANICCAS	ANICCA, (Sanskrit) the belief that everything is impermanent and constantly changing [n]
ANICUT	(Tamil) a dam or mole made in the course of a stream for the purpose of regulating the flow of a system of irrigation, also ANNICUT [n -S]
ANICUTS	ANICUT, (Tamil) a dam or mole made in the course of a stream for the purpose of regulating the flow of a system of irrigation, also ANNICUT [n]
ANKUS	(Hindi) an elephant goad, also ANKUSH [n -ES]
ANKUSES	ANKUS, (Hindi) an elephant goad, also ANKUSH [n]
ANKUSH	(Hindi) an elephant goad, also ANKUS [n -ES]
ANKUSHES	ANKUSH, (Hindi) an elephant goad, also ANKUS [n]
ANNA	(Hindi) a former coin of India [n -S]
ANNAS	ANNA, (Hindi) a former coin of India [n]
ANNICUT	(Tamil) a dam or mole made in the course of a stream for the purpose of regulating the flow of a system of irrigation, also ANICUT [n -S]
ANNICUTS	ANNICUT, (Tamil) a dam or mole made in the course of a stream for the purpose of regulating the flow of a system of irrigation, also ANICUT [n]
APSARAS	(Sanskrit) a divine water sprite [n -ES]
APSARASES	APSARAS, (Sanskrit) a divine water sprite [n]
ARGALA	(Hindi) the adjutant stork of India [n -S]
ARGALAS	ARGALA, (Hindi) the adjutant stork of India [n]
ARGUS	(Greek) an East Indian pheasant with a long colourful tail with eyespots [n -ES]
ARGUSES	ARGUS, (Greek) an East Indian pheasant with a long colourful tail with eyespots [n]
ARHAT	(Sanskrit) a Buddhist who has attained nirvana [n -S]
ARHATS	ARHAT, (Sanskrit) a Buddhist who has attained nirvana [n]
ARNA	(Hindi) an Indian water-buffalo [n -S]
ARNAS	ARNA, (Hindi) an Indian water-buffalo [n]
ARTI	(Hindi) an Indian ceremony in which candles dipped in ghee are lighted and offered to various deities, also AARTI [n -S]
ARTIS	ARTI, (Hindi) an Indian ceremony in which candles dipped in ghee are lighted and offered to various deities, also AARTI [n]
ASANA	(Sanskrit) a yoga posture [n -S]
ASANAS	ASANA, (Sanskrit) a yoga posture [n]
ASHRAM	(Sanskrit) the dwelling of a Hindu religious philosopher, also ASRAMA [n -S]
ASHRAMA	(Sanskrit) any one of the four stages of life which a man should pass through [n -S]
ASHRAMAS	ASHRAMA, (Sanskrit) any one of the four stages of life which a man should pass through [n]
ASHRAMS	ASHRAM, (Sanskrit) the dwelling of a Hindu religious philosopher, also ASRAMA [n]
ASRAMA	(Sanskrit) the dwelling of a Hindu religious philosopher, also ASHRAM [n -S]
ASRAMAS	ASRAMA, (Sanskrit) the dwelling of a Hindu religious philosopher, also ASHRAM [n]
ASTANGA	(Sanskrit) a form of yoga, also ASHTANGA, ASTHANGA [n -S]
ASTANGAS	ASTANGA, (Sanskrit) a form of yoga, also ASHTANGA, ASTHANGA [n]
ASTHANGA	(Sanskrit) a form of yoga, also ASHTANGA, ASTANGA [n -S]
ASTHANGAS	ASTHANGA, (Sanskrit) a form of yoga, also ASHTANGA, ASTANGA [n]
ASURA	(Sanskrit) a Hindu demon [n -S]
ASURAS	ASURA, (Sanskrit) a Hindu demon [n]
ATMA	(Sanskrit) the essential self, also ATMAN [n -S]
ATMAN	(Sanskrit) the essential self, also AATMAN, ATMA [n -S]
ATMANS	ATMAN, (Sanskrit) the essential self, also AATMAN, ATMA [n]
ATMAS	ATMA, (Sanskrit) the essential self, also ATMAN [n]
AUMIL	(Urdu) a factor or manager in India, a collector of revenues, also AMILDAR, AUMILDAR [n -S]
AUMILDAR	(Urdu) a factor or manager in India, a collector of revenues, also AMILDAR, AUMIL [n -S]
AUMILDARS	AUMILDAR, (Urdu) a factor or manager in India, a collector of revenues, also AMILDAR, AUMIL [n]
AUMILS	AUMIL, (Urdu) a factor or manager in India, a collector of revenues, also AMILDAR, AUMILDAR [n]
AUTORICKSHAW	a light, three-wheeled vehicle powered by a motorcycle engine, used in India, etc. [n -S]
AUTORICKSHAWS	AUTORICKSHAW, a light, three-wheeled vehicle powered by a motorcycle engine, used in India, etc. [n]
AVADAVAT	(Hindi) the strawberry finch, a small Indian song bird, commonly caged and kept for fighting, also AMADAVAT [n -S]
AVADAVATS	AVADAVAT, (Hindi) the strawberry finch, a small Indian song bird, commonly caged and kept for fighting, also AMADAVAT [n]
AVATAR	(Sanskrit) the incarnation of a Hindu deity [n -S]
AVATARS	AVATAR, (Sanskrit) the incarnation of a Hindu deity [n]
AYAH	(Hindi) in India, a maid or nurse, also AIA [n -S]
AYAHS	AYAH, (Hindi) in India, a maid or nurse, also AIA [n]
AYURVEDA	(Sanskrit) the traditional system of Indian medicine [n -S]
AYURVEDAS	AYURVEDA, (Sanskrit) the traditional system of Indian medicine [n]
AYURVEDIC	relating to ayurveda, the traditional system of Indian medicine [adj]
AYURVEDICS	the traditional system of Indian medicine [n]
BABLAH	(Hindi) a species of acacia from which gum arabic is obtained, also BABOOL, BABUL [n -S]
BABLAHS	BABLAH, (Hindi) a species of acacia from which gum arabic is obtained, also BABOOL, BABUL [n]
BABOO	(Hindi) a native clerk who writes English; also, a Hindu title answering to Mr. or Esquire, also BABU [n -S]
BABOOL	(Hindi) a species of acacia from which gum arabic is obtained, also BABLAH, BABUL [n -S]
BABOOLS	BABOOL, (Hindi) a species of acacia from which gum arabic is obtained, also BABLAH, BABUL [n]
BABOOS	BABOO, (Hindi) a native clerk who writes English; also, a Hindu title answering to Mr. or Esquire, also BABU [n]
BABU	(Hindi) a native clerk who writes English; also, a Hindu title answering to Mr. or Esquire, also BABOO [n -S]
BABUL	(Hindi) a species of acacia from which gum arabic is obtained, also BABLAH, BABOOL [n -S]
BABULS	BABUL, (Hindi) a species of acacia from which gum arabic is obtained, also BABLAH, BABOOL [n]
BABUS	BABU, (Hindi) a native clerk who writes English; also, a Hindu title answering to Mr. or Esquire, also BABOO [n]
BACHA	(Hinglish) in India, a young child, also BACHCHA [n -S]
BACHAS	BACHA, (Hinglish) in India, a young child, also BACHCHA [n]
BACHCHA	(Hinglish) in India, a young child, also BACHA [n -S]
BACHCHAS	BACHCHA, (Hinglish) in India, a young child, also BACHA [n]
BADAMASH	(Hindi) an evil-doer, a worthless person, also BADMASH, BUDMASH [n -ES]
BADAMASHES	BADAMASH, (Hindi) an evil-doer, a worthless person, also BADMASH, BUDMASH [n]
BADMASH	(Urdu) an evildoer, a worthless person, also BUDMASH [n -ES]
BADMASHES	BADMASH, (Urdu) an evildoer, a worthless person, also BUDMASH [n]
BAEL	(Hindi) a thorny Indian tree [n -S]
BAELS	BAEL, (Hindi) a thorny Indian tree [n]
BAFT	(Urdu) a kind of coarse fabric [n -S]
BAFTA	a coarse fabric made in India, also BAFT [n -S]
BAFTAS	BAFTA, a coarse fabric made in India, also BAFT [n]
BAFTS	BAFT, (Urdu) a kind of coarse fabric [n]
BAGH	(Hindi) a garden [n -S]
BAGHS	BAGH, (Hindi) a garden [n]
BAHADUR	(Urdu) a Hindu title of respect, meaning hero or great one [n -S]
BAHADURS	BAHADUR, (Urdu) a Hindu title of respect, meaning hero or great one [n]
BAHU	(Hindi) a daughter-in-law, especially one who lives with her husband's family when married [n -S]
BAHUS	BAHU, (Hindi) a daughter-in-law, especially one who lives with her husband's family when married [n]
BAHUVRIHI	(Sanskrit) a class of compound words where the first element describes the second but cannot substitute for it, e.g. turncoat [n -S]
BAHUVRIHIS	BAHUVRIHI, (Sanskrit) a class of compound words where the first element describes the second but cannot substitute for it, e.g. turncoat [n]
BAJRA	(Hindi) in the Indian subcontinent, pearl millet or a similar grain, also BAJREE, BAJRI [n -S]
BAJRAS	BAJRA, (Hindi) in the Indian subcontinent, pearl millet or a similar grain, also BAJREE, BAJRI [n]
BAJREE	(Hindi) in the Indian subcontinent, pearl millet or a similar grain, also BAJRA, BAJRI [n -S]
BAJREES	BAJREE, (Hindi) in the Indian subcontinent, pearl millet or a similar grain, also BAJRA, BAJRI [n]
BAJRI	(Hindi) in the Indian subcontinent, pearl millet or a similar grain, also BAJRA, BAJREE [n -S]
BAJRIS	BAJRI, (Hindi) in the Indian subcontinent, pearl millet or a similar grain, also BAJRA, BAJREE [n]
BALOO	(Hindi) a bear, also BALU [n -S]
BALOOS	BALOO, (Hindi) a bear, also BALU [n]
BALTI	(Hindi) a spicy Indian dish [n -S]
BALTIS	BALTI, (Hindi) a spicy Indian dish [n]
BALU	(Hindi) a bear, also BALOO [n -S]
BALUS	BALU, (Hindi) a bear, also BALOO [n]
BANDANA	(Hindi) a large coloured handkerchief or headscarf, also BANDANNA [n -S]
BANDANAS	BANDANA, (Hindi) a large coloured handkerchief or headscarf, also BANDANNA [n]
BANDANNA	(Hindi) a coloured silk or cotton handkerchief or headscarf, also BANDANA [n -S]
BANDANNAS	BANDANNA, (Hindi) a coloured silk or cotton handkerchief or headscarf, also BANDANA [n]
BANDAR	(Hindi) a rhesus monkey [n -S]
BANDARI	(Hindi) a female monkey or a cheeky girl, also BANDARIYA [n -S]
BANDARIS	BANDARI, (Hindi) a female monkey or a cheeky girl, also BANDARIYA [n]
BANDARIYA	(Hindi) a female monkey or a cheeky girl, also BANDARI [n -S]
BANDARIYAS	BANDARIYA, (Hindi) a female monkey or a cheeky girl, also BANDARI [n]
BANDARS	BANDAR, (Hindi) a rhesus monkey [n]
BANDH	(Hindi) in India, a general strike, also BUNDH [n -S]
BANDHS	BANDH, (Hindi) in India, a general strike, also BUNDH [n]
BANDICOOT	a species of very large rat, found in India and Ceylon [n -S] / to remove potatoes from the ground leaving the tops undisturbed [v BANDICOOTED, BANDICOOTING, BANDICOOTS]
BANDOBAST	(Urdu) an organisation, also BANDOBUST, BUNDOBUST [n -S]
BANDOBASTS	BANDOBAST, (Urdu) an organisation, also BANDOBUST, BUNDOBUST [n]
BANDOBUST	(Urdu) (in India and Pakistan) an arrangement, also BANDOBAST, BUNDOBUST [n -S]
BANDOBUSTS	BANDOBUST, (Urdu) (in India and Pakistan) an arrangement, also BANDOBAST, BUNDOBUST [n]
BANDOOK	(Urdu) Indian army slang for a rifle, a shotgun, also BUNDOOK [n -S]
BANDOOKS	BANDOOK, (Urdu) Indian army slang for a rifle, a shotgun, also BUNDOOK [n]
BANDYMAN	in India, one who drives a bandy, a carriage or bullock cart [n BANDYMEN]
BANDYMEN	BANDYMAN, in India, one who drives a bandy, a carriage or bullock cart [n]
BANGLE	(Hindi) a rigid ring as a bracelet or anklet [n -S]
BANGLES	BANGLE, (Hindi) a rigid ring as a bracelet or anklet [n]
BANIA	(Hindi) an Indian fig tree [n -S]
BANIAN	(Hindi) a Hindu trader [n -S]
BANIANS	BANIAN, (Hindi) a Hindu trader [n]
BANIAS	BANIA, (Hindi) an Indian fig tree [n]
BANYAN	(Hindi) an Indian fig tree with vast spreading branches; a Hindu trader, also BANIA, BANIAN [n -S]
BANYANS	BANYAN, (Hindi) an Indian fig tree with vast spreading branches; a Hindu trader, also BANIA, BANIAN [n]
BAPU	(Hindi) a spiritual father [n -S]
BAPUS	BAPU, (Hindi) a spiritual father [n]
BARASINGA	(Hindi) the Indian swamp-deer, also BARASINGHA [n -S]
BARASINGAS	BARASINGA, (Hindi) the Indian swamp-deer, also BARASINGHA [n]
BARASINGHA	(Hindi) the Indian swamp-deer, also BARASINGA [n -S]
BARASINGHAS	BARASINGHA, (Hindi) the Indian swamp-deer, also BARASINGA [n]
BARFI	(Hindi) an Indian dessert made from milk solids and sugar, also BURFI [n -S]
BARFIS	BARFI, (Hindi) an Indian dessert made from milk solids and sugar, also BURFI [n]
BASANT	(Urdu) a Pakistani spring festival [n -S]
BASANTS	BASANT, (Urdu) a Pakistani spring festival [n]
BASMATI	(Hindi) a type of long grain rice [n -S]
BASMATIS	BASMATI, (Hindi) a type of long grain rice [n]
BASTI	(Urdu) a slum, also BUSTI, BUSTEE [n -S]
BASTIS	BASTI, (Urdu) a slum, also BUSTI, BUSTEE [n]
BATTA	extra pay; esp. an extra allowance to an English officer serving in India [n -S]
BATTAS	BATTA, extra pay; esp. an extra allowance to an English officer serving in India [n]
BEEDI	(Hindi) a hand rolled cigarette, also BIDI, BEEDIE [n BEEDIES]
BEEDIE	(Hindi) a cheap thin Indian cigarette, sometimes fruit-flavoured, also BIDI, BEEDI [n -S]
BEEDIES	BEEDIE, (Hindi) a cheap thin Indian cigarette, sometimes fruit-flavoured, also BIDI, BEEDI [n]
BEEGAH	(Hindi) an Indian land measure, also BIGHA [n -S]
BEEGAHS	BEEGAH, (Hindi) an Indian land measure, also BIGHA [n]
BEGAR	(Hindi) forced labour in India [n -S]
BEGARS	BEGAR, (Hindi) forced labour in India [n]
BEGUM	(Urdu) a high ranking Muslim lady [n -S]
BEGUMS	BEGUM, (Urdu) a high ranking Muslim lady [n]
BENJ	(Arabic) cannabis, Indian hemp, used as a weak narcotic, also BHANG [n -ES]
BENJES	BENJ, (Arabic) cannabis, Indian hemp, used as a weak narcotic, also BHANG [n]
BERIBERI	(Sinhalese) a disease caused by a lack of vitamin B [n -S]
BERIBERIS	BERIBERI, (Sinhalese) a disease caused by a lack of vitamin B [n]
BESTI	(Hinglish) in India, shame [n -S]
BESTIS	BESTI, (Hinglish) in India, shame [n]
BHAGEE	(Hindi) in Indian cookery, an appetizer, also BHAJEE, BHAJI [n -S]
BHAGEES	BHAGEE, (Hindi) in Indian cookery, an appetizer, also BHAJEE, BHAJI [n]
BHAI	(Hindi) brother; a form of address for a man [n -S]
BHAIS	BHAI, (Hindi) brother; a form of address for a man [n]
BHAJAN	a Hindu religious song [n -S]
BHAJANS	BHAJAN, a Hindu religious song [n]
BHAJEE	(Hindi) in Indian cookery, an appetizer, also BHAJI, BHAGEE [n -S]
BHAJEES	BHAJEE, (Hindi) in Indian cookery, an appetizer, also BHAJI, BHAGEE [n]
BHAJI	(Hindi) in Indian cookery, an appetizer consisting of vegetables cooked in batter, also BHAGEE, BHAJEE [n BHAJIA or BHAJIS]
BHAJIA	BHAJI, (Hindi) in Indian cookery, an appetizer consisting of vegetables cooked in batter, also BHAGEE, BHAJEE [n]
BHAJIS	BHAJI, (Hindi) in Indian cookery, an appetizer consisting of vegetables cooked in batter, also BHAGEE, BHAJEE [n]
BHAKTA	(Sanskrit) devotion to a god, as a path to salvation, also BHAKTI [n -S]
BHAKTAS	BHAKTA, (Sanskrit) devotion to a god, as a path to salvation, also BHAKTI [n]
BHAKTI	(Sanskrit) devotion to a god, as a path to salvation, also BHAKTA [n -S]
BHAKTIS	BHAKTI, (Sanskrit) devotion to a god, as a path to salvation, also BHAKTA [n]
BHANG	(Hindi) cannabis, Indian hemp, used as a weak narcotic, also BENJ [n -S]
BHANGRA	(Punjabi) a combination of traditional Punjabi and Western pop music [n -S]
BHANGRAS	BHANGRA, (Punjabi) a combination of traditional Punjabi and Western pop music [n]
BHANGS	BHANG, (Hindi) cannabis, Indian hemp, used as a weak narcotic, also BENJ [n]
BHARAL	(Hindi) a blue Himalayan sheep, also BURRELL, BURRHEL [n -S]
BHARALS	BHARAL, (Hindi) a blue Himalayan sheep, also BURRELL, BURRHEL [n]
BHAVAN	(Hindi) a large house, also BHAWAN [n -S]
BHAVANS	BHAVAN, (Hindi) a large house, also BHAWAN [n]
BHAWAN	(Hindi) a large house, also BHAVAN [n -S]
BHAWANS	BHAWAN, (Hindi) a large house, also BHAVAN [n]
BHEESTIE	(Urdu) an Indian water carrier, also BHEESTY, BHISHTI, BHISTEE, BHISTI, BHISTIE [n -S]
BHEESTIES	BHEESTY, (Urdu) an Indian water carrier, also BHEESTIE, BHISHTI, BHISTEE, BHISTI, BHISTIE [n]
BHEESTY	(Urdu) an Indian water carrier, also BHEESTIE, BHISHTI, BHISTEE, BHISTI, BHISTIE [n BHEESTIES]
BHEL	(Hindi) a thorny Indian tree, also BAEL [n -S]
BHELPURI	an Indian dish of puffed rice with onions [n -S]
BHELPURIS	BHELPURI, an Indian dish of puffed rice with onions [n]
BHELS	BHEL, (Hindi) a thorny Indian tree, also BAEL [n]
BHINDI	(Hindi) the vegetable okra as used in Indian cookery [n -S]
BHINDIS	BHINDI, (Hindi) the vegetable okra as used in Indian cookery [n]
BHISHTI	(Hindi) an Indian water carrier, also BHEESTIE, BHEESTY, BHISTEE, BHISTI, BHISTIE [n -S]
BHISHTIS	BHISHTI, (Hindi) an Indian water carrier, also BHEESTIE, BHEESTY, BHISTEE, BHISTI, BHISTIE [n]
BHISTEE	(Urdu) an Indian water carrier, also BHEESTIE, BHEESTY, BHISHTI, BHISTI, BHISTIE [n -S]
BHISTEES	BHISTEE, (Urdu) an Indian water carrier, also BHEESTIE, BHEESTY, BHISHTI, BHISTI, BHISTIE [n]
BHISTI	(Urdu) an Indian water carrier, also BHEESTIE, BHEESTY, BHISHTI, BHISTEE, BHISTIE [n -S]
BHISTIE	(Urdu) an Indian water carrier, also BHEESTIE, BHEESTY, BHISHTI, BHISTEE, BHISTI [n -S]
BHISTIES	BHISTIE, (Urdu) an Indian water carrier, also BHEESTIE, BHEESTY, BHISHTI, BHISTEE, BHISTI [n]
BHISTIS	BHISTI, (Urdu) an Indian water carrier, also BHEESTIE, BHEESTY, BHISHTI, BHISTEE, BHISTIE [n]
BHOOT	(Hindi) a small whirlwind, also BHUT [n -S]
BHOOTS	BHOOT, (Hindi) a small whirlwind, also BHUT [n]
BHUNA	(Urdu) an Indian sauce, also BHOONA [n -S]
BHUNAS	BHUNA, (Urdu) an Indian sauce, also BHOONA [n]
BHUT	(Hindi) a small whirlwind, also BHOOT [n -S]
BHUTS	BHUT, (Hindi) a small whirlwind, also BHOOT [n]
BIDI	(Hindi) a hand rolled cigarette, also BEEDI, BEEDIE [n -S]
BIDIS	BIDI, (Hindi) a hand rolled cigarette, also BEEDI, BEEDIE [n]
BIGHA	(Hindi) an Indian land measure, also BEEGAH [n -S]
BIGHAS	BIGHA, (Hindi) an Indian land measure, also BEEGAH [n]
BINDAAS	(Hindi) a carefree and daring person, also BINDASS [n -ES]
BINDAASES	BINDAAS, (Hindi) a carefree and daring person, also BINDASS [n]
BINDASS	(Hindi) a carefree and daring person, also BINDAAS [n -ES]
BINDASSES	BINDASS, (Hindi) a carefree and daring person, also BINDAAS [n]
BINDHI	(Hindi) a dot worn on the forehead by women in India, also BINDI [n -S]
BINDHIS	BINDHI, (Hindi) a dot worn on the forehead by women in India, also BINDI [n]
BINDI	(Hindi) a dot worn on the forehead by women in India, also BINDHI [n -S]
BINDIS	BINDI, (Hindi) a dot worn on the forehead by women in India, also BINDHI [n]
BIRIANI	(Urdu) a spicy rice dish, also BIRIYANI, BIRYANI [n -S]
BIRIANIS	BIRIANI, (Urdu) a spicy rice dish, also BIRIYANI, BIRYANI [n]
BIRIYANI	(Urdu) a spicy rice dish, also BIRIANI, BIRYANI [n -S]
BIRIYANIS	BIRIYANI, (Urdu) a spicy rice dish, also BIRIANI, BIRYANI [n]
BIRYANI	(Urdu) a spicy rice dish, also BIRIANI, BIRIYANI [n -S]
BIRYANIS	BIRYANI, (Urdu) a spicy rice dish, also BIRIANI, BIRIYANI [n]
BLACKBUCK	an Indian antelope [n -S]
BLACKBUCKS	BLACKBUCK, an Indian antelope [n]
BOORKA	(Urdu) a coverall worn by Muslim women, also BURKA, BOURKHA, BURQA [n -S]
BOORKAS	BOORKA, (Urdu) a coverall worn by Muslim women, also BURKA, BOURKHA, BURQA [n]
BOURKHA	(Urdu) a coverall worn by Muslim women, also BURKA, BOORKA, BURQA [n -S]
BOURKHAS	BOURKHA, (Urdu) a coverall worn by Muslim women, also BURKA, BOORKA, BURQA [n]
BOXWALLAH	(Hindi) a pedlar; a businessman [n -S]
BOXWALLAHS	BOXWALLAH, (Hindi) a pedlar; a businessman [n]
BRAHMA	(Hindi) a large domestic fowl [n -S]
BRAHMAN	(Hindi) a member of the highest Hindu caste, also BRAHMIN [n -S]
BRAHMANI	(Hindi) a female member of the highest Hindu caste, also BRAHMIN [n -S]
BRAHMANIS	BRAHMANI, (Hindi) a female member of the highest Hindu caste, also BRAHMIN [n]
BRAHMANISM	the religious and social system of orthodox Hinduism, also BRAHMINISM [n -S]
BRAHMANISMS	BRAHMANISM, the religious and social system of orthodox Hinduism, also BRAHMINISM [n]
BRAHMANS	BRAHMAN, (Hindi) a member of the highest Hindu caste, also BRAHMIN [n]
BRAHMAS	BRAHMA, (Hindi) a large domestic fowl [n]
BRAHMIN	(Hindi) a member of the highest Hindu caste, also BRAHMAN [n -S]
BRAHMINISM	the religious and social system of orthodox Hinduism, also BRAHMANISM [n -S]
BRAHMINISMS	BRAHMINISM, the religious and social system of orthodox Hinduism, also BRAHMANISM [n]
BRAHMINS	BRAHMIN, (Hindi) a member of the highest Hindu caste, also BRAHMAN [n]
BRAZIL	the hard reddish wood of the East Indian sappan tree [n -S]
BRAZILS	BRAZIL, the hard reddish wood of the East Indian sappan tree [n]
BRINJAL	(Sanskrit) the aubergine [n -S]
BRINJALS	BRINJAL, (Sanskrit) the aubergine [n]
BRINJARRIES	BRINJARRY, (Hindi) a travelling dealer in grain and salt in South India [n]
BRINJARRY	(Hindi) a travelling dealer in grain and salt in South India [n BRINJARRIES]
BRULE	(French) a mixed race person of Canadian Indian and French ancestry [n -S]
BRULES	BRULE, (French) a mixed race person of Canadian Indian and French ancestry [n]
BUDDHA	(Sanskrit) a statue of the Buddha [n -S]
BUDDHAS	BUDDHA, (Sanskrit) a statue of the Buddha [n]
BUDGERO	(Hindi) a heavy keelless barge, also BUDGEROW [n -S]
BUDGEROS	BUDGERO, (Hindi) a heavy keelless barge, also BUDGEROW [n]
BUDGEROW	(Hindi) a heavy keelless barge, also BUDGERO [n -S]
BUDGEROWS	BUDGEROW, (Hindi) a heavy keelless barge, also BUDGERO [n]
BUDI	(Hindi) an insulting term for an old woman [n -S]
BUDIS	BUDI, (Hindi) an insulting term for an old woman [n]
BUDMASH	(Urdu) an evildoer, a worthless person, also BADMASH [n -ES]
BUDMASHES	BUDMASH, (Urdu) an evildoer, a worthless person, also BADMASH [n]
BULBUL	(Arabic) an Indian songbird [n -S]
BULBULS	BULBUL, (Arabic) an Indian songbird [n]
BUMALO	(Marathi) a small marine Asiatic fish used in India as a relish; aka Bombay duck, also BUMALOTI, BUMMALO, BUMMALOTI [n]
BUMALOTI	(Marathi) a small marine Asiatic fish used in India as a relish, aka Bombay duck, also BUMALO, BUMMALO, BUMMALOTI [n -S]
BUMALOTIS	BUMALOTI, (Marathi) a small marine Asiatic fish used in India as a relish, aka Bombay duck, also BUMALO, BUMMALO, BUMMALOTI [n]
BUMMALO	(Marathi) a small marine Asiatic fish used in India as a relish; aka Bombay duck, also BUMALO, BUMALOTI, BUMMALOTI [n -S]
BUMMALOS	BUMMALO, (Marathi) a small marine Asiatic fish used in India as a relish; aka Bombay duck, also BUMALO, BUMALOTI, BUMMALOTI [n]
BUMMALOTI	(Marathi) a small marine Asiatic fish used in India as a relish; aka Bombay duck, also BUMALO, BUMALOTI, BUMMALO [n -S]
BUMMALOTIS	BUMMALOTI, (Marathi) a small marine Asiatic fish used in India as a relish; aka Bombay duck, also BUMALO, BUMALOTI, BUMMALO [n]
BUNDH	(Hindi) in India, a general strike, also BANDH [n -S]
BUNDHS	BUNDH, (Hindi) in India, a general strike, also BANDH [n]
BUNDOBUST	(Urdu) an organisation, also BANDOBAST, BANDOBUST [n -S]
BUNDOBUSTS	BUNDOBUST, (Urdu) an organisation, also BANDOBAST, BANDOBUST [n]
BUNDOOK	(Urdu) Indian army slang for a rifle, a shotgun, also BANDOOK [n -S]
BUNDOOKS	BUNDOOK, (Urdu) Indian army slang for a rifle, a shotgun, also BANDOOK [n]
BUNGALOW	(Hindi) a lightly-built house, properly one with a veranda and one storey [n -S]
BUNGALOWS	BUNGALOW, (Hindi) a lightly-built house, properly one with a veranda and one storey [n]
BUNIA	(Hindi) an (Indian) corn-merchant, also BUNNIA [n -S]
BUNIAS	BUNIA, (Hindi) an (Indian) corn-merchant, also BUNNIA [n]
BUNNIA	(Hindi) an (Indian) corn-merchant, also BUNIA [n -S]
BUNNIAS	BUNNIA, (Hindi) an (Indian) corn-merchant, also BUNIA [n]
BURFI	(Hindi) an Indian dessert made from milk solids and sugar, also BARFI [n -S]
BURFIS	BURFI, (Hindi) an Indian dessert made from milk solids and sugar, also BARFI [n]
BURHEL	(Hindi) a blue Himalayan sheep [n -S]
BURHELS	BURHEL, (Hindi) a blue Himalayan sheep [n]
BURKA	(Urdu) a coverall worn by Muslim women, also BOORKA, BOURKHA, BURQA [n -S]
BURKAS	BURKA, (Urdu) a coverall worn by Muslim women, also BOORKA, BOURKHA, BURQA [n]
BURKHA	(Urdu) an Arab woman's head-covering, also BOORKA, BOURKHA, BURKA, BURQA [n -S]
BURKHAS	BURKHA, (Urdu) an Arab woman's head-covering, also BOORKA, BOURKHA, BURKA, BURQA [n]
BURQA	(Urdu) a coverall worn by Muslim women, also BURKA, BOORKA, BOURKHA [n -S]
BURQAS	BURQA, (Urdu) a coverall worn by Muslim women, also BURKA, BOORKA, BOURKHA [n]
BURREL	(Hindi) a Himalayan blue sheep, also BHARAL, BURHEL, BURRELL, BURRHEL [n -S]
BURRELL	(Hindi) a Himalayan blue sheep, also BHARAL, BURHEL, BURREL, BURRHEL [n -S]
BURRELLS	BURRELL, (Hindi) a Himalayan blue sheep, also BHARAL, BURHEL, BURREL, BURRHEL [n]
BURRELS	BURREL, (Hindi) a Himalayan blue sheep, also BHARAL, BURHEL, BURRELL, BURRHEL [n]
BURRHEL	(Hindi) a Himalayan blue sheep, also BHARAL, BURHEL, BURREL, BURRELL [n -S]
BURRHELS	BURRHEL, (Hindi) a Himalayan blue sheep, also BHARAL, BURHEL, BURREL, BURRELL [n]
BUSTEE	(Urdu) in India, a flimsy hut, a squatter colony, also BASTI, BUSTI [n -S]
BUSTEES	BUSTEE, (Urdu) in India, a flimsy hut, a squatter colony, also BASTI, BUSTI [n]
BUSTI	(Urdu) in India, a flimsy hut, a squatter colony, also BASTI, BUSTEE [n -S]
BUSTIS	BUSTI, (Urdu) in India, a flimsy hut, a squatter colony, also BASTI, BUSTEE [n]
CACHUMBER	(Hindi) an Indian side salad [n -S]
CACHUMBERS	CACHUMBER, (Hindi) an Indian side salad [n]
CALAMANDER	(Sinhalese) a hard valuable wood of the ebony genus [n -S]
CALAMANDERS	CALAMANDER, (Sinhalese) a hard valuable wood of the ebony genus [n]
CALPA	(Sanskrit) one of the Brahmanic eons, a period of 4,320,000,000 years, also KALPA [n -S]
CALPAS	CALPA, (Sanskrit) one of the Brahmanic eons, a period of 4,320,000,000 years, also KALPA [n]
CANDIE	(Tamil) a South Indian weight, approximately 500 lb. Imperial, also CANDY, KANDY [n -S]
CANDIED	CANDY, (Tamil) to coat with sugar [v]
CANDIES	CANDIE, (Tamil) a South Indian weight, approximately 500 lb. Imperial, also CANDY, KANDY [n]
CANDY	(Tamil) to coat with sugar [v CANDIED, CANDYING, CANDIES]
CANDYING	CANDY, (Tamil) to coat with sugar [v]
CARAMBOLA	(Portuguese) a small East Indian tree of the wood-sorrel family; its acrid yellow pulpy fruit used for making tarts, preserves, etc., aka starfruit [n -S]
CARAMBOLAS	CARAMBOLA, (Portuguese) a small East Indian tree of the wood-sorrel family; its acrid yellow pulpy fruit used for making tarts, preserves, etc., aka starfruit [n]
CASTEISM	the caste system esp. in India [n -S]
CASTEISMS	CASTEISM, the caste system esp. in India [n]
CATAMARAN	(Tamil) originally a raft of logs lashed together; now a boat, esp. a sailing boat with two hulls [n -S]
CATAMARANS	CATAMARAN, (Tamil) originally a raft of logs lashed together; now a boat, esp. a sailing boat with two hulls [n]
CHABOUK	(Urdu) a type of horsewhip, also CHABUK [n -S]
CHABOUKS	CHABOUK, (Urdu) a type of horsewhip, also CHABUK [n]
CHABUK	(Urdu) a type of horsewhip, also CHABOUK [n -S]
CHABUKS	CHABUK, (Urdu) a type of horsewhip, also CHABOUK [n]
CHAKRA	(Sanskrit) in yoga, one of the seven centres of spiritual power in the body [n -S]
CHAKRAS	CHAKRA, (Sanskrit) in yoga, one of the seven centres of spiritual power in the body [n]
CHALAN	(Urdu) in India, to cause (an accused person) to appear before a magistrate [v CHALANED or CHALANNED, CHALANING or CHALANNING, CHALANS]
CHALANED	CHALAN, (Urdu) in India, to cause (an accused person) to appear before a magistrate [v]
CHALANING	CHALAN, (Urdu) in India, to cause (an accused person) to appear before a magistrate [v]
CHALANNED	CHALAN, (Urdu) in India, to cause (an accused person) to appear before a magistrate [v]
CHALANNING	CHALAN, (Urdu) in India, to cause (an accused person) to appear before a magistrate [v]
CHALANS	CHALAN, (Urdu) in India, to cause (an accused person) to appear before a magistrate [v]
CHALLAN	(Urdu) a waybill; a pass, also CHALAN [n -S]
CHALLANS	CHALLAN, (Urdu) a waybill; a pass, also CHALAN [n]
CHAMPAC	(Hindi) an East Indian tree of the magnolia family, sacred to Hindus, also CHAMPACA, CHAMPAK [n -S]
CHAMPACA	(Hindi) an East Indian tree of the magnolia family, sacred to Hindus, also CHAMPAC, CHAMPAK [n -S]
CHAMPACAS	CHAMPACA, (Hindi) an East Indian tree of the magnolia family, sacred to Hindus, also CHAMPAC, CHAMPAK [n]
CHAMPACS	CHAMPAC, (Hindi) an East Indian tree of the magnolia family, sacred to Hindus, also CHAMPACA, CHAMPAK [n]
CHAMPAK	(Hindi) an East Indian tree of the magnolia family, sacred to Hindus, also CHAMPAC, CHAMPACA [n -S]
CHAMPAKS	CHAMPAK, (Hindi) an East Indian tree of the magnolia family, sacred to Hindus, also CHAMPAC, CHAMPACA [n]
CHANA	(Hindi) in Indian cookery, the chickpea, also CHANNA [n -S]
CHANAS	CHANA, (Hindi) in Indian cookery, the chickpea, also CHANNA [n]
CHANGA	(Hinglish) an expression of approval or agreement [interj]
CHANK	(Hindi) the shell of several species of sea conch, used to make bangles [n -S]
CHANKS	CHANK, (Hindi) the shell of several species of sea conch, used to make bangles [n]
CHANNA	(Hindi) in Indian cookery, the chickpea, also CHANA [n -S]
CHANNAS	CHANNA, (Hindi) in Indian cookery, the chickpea, also CHANA [n]
CHAPATI	(Hindi) a thin piece of unleavened bread, also CHAPATTI, CHAPPATI [n CHAPATIS or CHAPATIES]
CHAPATIES	CHAPATI, (Hindi) a thin piece of unleavened bread, also CHAPATTI, CHAPPATI [n]
CHAPATIS	CHAPATI, (Hindi) a thin piece of unleavened bread, also CHAPATTI, CHAPPATI [n]
CHAPATTI	(Hindi) a thin flat piece of unleavened bread, also CHAPATI, CHAPPATI, CHUPATI, CHUPATTI, CHUPATTY [n CHAPATTIS or CHAPATTIES]
CHAPATTIES	CHAPATTI, (Hindi) a thin flat piece of unleavened bread, also CHAPATI, CHAPPATI, CHUPATI, CHUPATTI, CHUPATTY [n]
CHAPATTIS	CHAPATTI, (Hindi) a thin flat piece of unleavened bread, also CHAPATI, CHAPPATI, CHUPATI, CHUPATTI, CHUPATTY [n]
CHAPPAL	(Hindi) a type of open sandal worn in India [n -S]
CHAPPALS	CHAPPAL, (Hindi) a type of open sandal worn in India [n]
CHAPPATI	(Hindi) a thin flat piece of unleavened bread, also CHAPATI, CHAPATTI, CHUPATI, CHUPATTI, CHUPATTY [n -S]
CHAPPATIS	CHAPPATI, (Hindi) a thin flat piece of unleavened bread, also CHAPATI, CHAPATTI, CHUPATI, CHUPATTI, CHUPATTY [n]
CHAPRASI	(Hindi) an office messenger or doorman [n -S]
CHAPRASIS	CHAPRASI, (Hindi) an office messenger or doorman [n]
CHAPRASSI	(Urdu) an office messenger, a household attendant, also CHUPRASSY [n CHAPRASSIS or CHAPRASSIES]
CHAPRASSIES	CHAPRASSI, (Urdu) an office messenger, a household attendant, also CHUPRASSY [n]
CHAPRASSIS	CHAPRASSI, (Urdu) an office messenger, a household attendant, also CHUPRASSY [n]
CHARAS	(Hindi) the resinous exudation of hashish, a narcotic and intoxicant, also CHURRUS [n -ES]
CHARASES	CHARAS, (Hindi) the resinous exudation of hashish, a narcotic and intoxicant, also CHURRUS [n]
CHARKA	(Urdu) a spinning wheel, also CHARKHA [n -S]
CHARKAS	CHARKA, (Urdu) a spinning wheel, also CHARKHA [n]
CHARKHA	(Urdu) a spinning wheel, also CHARKA [n -S]
CHARKHAS	CHARKHA, (Urdu) a spinning wheel, also CHARKA [n]
CHARPAI	(Urdu) a string framed bed, also CHARPOY [n -S]
CHARPAIS	CHARPAI, (Urdu) a string framed bed, also CHARPOY [n]
CHARPOY	(Urdu) a string framed bed, also CHARPAI [n -S]
CHARPOYS	CHARPOY, (Urdu) a string framed bed, also CHARPAI [n]
CHATTA	(Hindi) an umbrella, also CHHATA [n -S]
CHATTAS	CHATTA, (Hindi) an umbrella, also CHHATA [n]
CHATTEE	(Hindi) an earthenware water pot, also CHATTI, CHATTY [n -S]
CHATTEES	CHATTEE, (Hindi) an earthenware water pot, also CHATTI, CHATTY [n]
CHATTI	(Hindi) an earthenware water pot, also CHATTEE, CHATTY [n -S]
CHATTIS	CHATTI, (Hindi) an earthenware water pot, also CHATTEE, CHATTY [n]
CHAY	(Tamil) an Indian plant of the madder family whose root chayroot yields a red dye, also CHAYA, SHAYA [n -S]
CHAYA	(Tamil) an Indian plant of the madder family whose root chayroot yields a red dye, also CHAY, SHAYA [n -S]
CHAYAS	CHAYA, (Tamil) an Indian plant of the madder family whose root chayroot yields a red dye, also CHAY, SHAYA [n]
CHAYROOT	the root of the chay, an Indian plant of the madder family [n -S]
CHAYROOTS	CHAYROOT, the root of the chay, an Indian plant of the madder family [n]
CHAYS	CHAY, (Tamil) an Indian plant of the madder family whose root chayroot yields a red dye, also CHAYA, SHAYA [n]
CHEETAH	(Hindi) a hunting cat of Africa, also CHETAH [n -S]
CHEETAHS	CHEETAH, (Hindi) a hunting cat of Africa, also CHETAH [n]
CHEROOT	(Tamil) a square-cut cigar, also SHEROOT [n -S]
CHEROOTS	CHEROOT, (Tamil) a square-cut cigar, also SHEROOT [n]
CHETAH	(Hindi) a swift-running wildcat, also CHEETAH [n -S]
CHETAHS	CHETAH, (Hindi) a swift-running wildcat, also CHEETAH [n]
CHHATA	(Hindi) an umbrella, also CHATTA [n -S]
CHHATAS	CHHATA, (Hindi) an umbrella, also CHATTA [n]
CHIK	(Hindi) a slatted blind [n -S]
CHIKARA	(Hindi) a four-horned Indian antelope, also CHINKARA [n -S]
CHIKARAS	CHIKARA, (Hindi) a four-horned Indian antelope, also CHINKARA [n]
CHIKHOR	(Hindi) an Indian partridge, also CHIKOR, CHUKAR, CHUKOR [n -S]
CHIKHORS	CHIKHOR, (Hindi) an Indian partridge, also CHIKOR, CHUKAR, CHUKOR [n]
CHIKOR	(Hindi) an Indian partridge, also CHIKHOR, CHUKAR, CHUKOR [n -S]
CHIKORS	CHIKOR, (Hindi) an Indian partridge, also CHIKHOR, CHUKAR, CHUKOR [n]
CHIKS	CHIK, (Hindi) a slatted blind [n]
CHILLUM	(Hindi) the part of a hookah water-pipe containing the bowl and tobacco-balls [n -S]
CHILLUMS	CHILLUM, (Hindi) the part of a hookah water-pipe containing the bowl and tobacco-balls [n]
CHINKARA	(Hindi) a four-horned Indian antelope, also CHIKARA [n -S]
CHINKARAS	CHINKARA, (Hindi) a four-horned Indian antelope, also CHIKARA [n]
CHITAL	(Hindi) a kind of Indian deer, aka axis deer [n -S]
CHITALS	CHITAL, (Hindi) a kind of Indian deer, aka axis deer [n]
CHITTAGONG	an Indian variety of domestic fowl [n -S]
CHITTAGONGS	CHITTAGONG, an Indian variety of domestic fowl [n]
CHLORODYNE	a patent anodyne medicine, containing opium, chloroform, Indian hemp, etc. [n -S]
CHLORODYNES	CHLORODYNE, a patent anodyne medicine, containing opium, chloroform, Indian hemp, etc. [n]
CHOBDAR	(Urdu) in the Indian subcontinent, an usher bearing a staff, attending on a dignitary [n -S]
CHOBDARS	CHOBDAR, (Urdu) in the Indian subcontinent, an usher bearing a staff, attending on a dignitary [n]
CHOKIDAR	(Urdu) a watchman, also CHOWKIDAR [n -S]
CHOKIDARS	CHOKIDAR, (Urdu) a watchman, also CHOWKIDAR [n]
CHOKRA	(Hindi) a boy; a household or regimental servant [n -S]
CHOKRAS	CHOKRA, (Hindi) a boy; a household or regimental servant [n]
CHOKRI	(Hindi) a girl; a female household or regimental servant [n -S]
CHOKRIS	CHOKRI, (Hindi) a girl; a female household or regimental servant [n]
CHOLI	(Hindi) a short, close-fitting blouse worn under a sari [n -S]
CHOLIS	CHOLI, (Hindi) a short, close-fitting blouse worn under a sari [n]
CHOLTRIES	CHOLTRY, (Malayalam) a shed used for assembly, also CHOULTRY [n]
CHOLTRY	(Malayalam) a shed used for assembly, also CHOULTRY [n CHOLTRIES]
CHOTA	(Hindi) a person of lower rank [n -S]
CHOTAS	CHOTA, (Hindi) a person of lower rank [n]
CHOULTRIES	CHOULTRY, (Malayalam) a shed used for assembly, also CHOLTRY [n]
CHOULTRY	(Malayalam) a shed used for assembly, also CHOLTRY [n CHOULTRIES]
CHOUT	(Hindi) in India, an assessment equal to a fourth part of the revenue, extracted by the Mahrattas as blackmail [n -S]
CHOUTS	CHOUT, (Hindi) in India, an assessment equal to a fourth part of the revenue, extracted by the Mahrattas as blackmail [n]
CHOWK	(Hindi) a marketplace [n -S]
CHOWKIDAR	(Urdu) a watchman, also CHOKIDAR [n -S]
CHOWKIDARS	CHOWKIDAR, (Urdu) a watchman, also CHOKIDAR [n]
CHOWKS	CHOWK, (Hindi) a marketplace [n]
CHOWRI	(Hindi) a whisk to keep off flies, used in the East Indies, also CHOWRY [n -S]
CHOWRIES	CHOWRY, (Hindi) a whisk to keep off flies, used in the East Indies, also CHOWRI [n]
CHOWRIS	CHOWRI, (Hindi) a whisk to keep off flies, used in the East Indies, also CHOWRY [n]
CHOWRY	(Hindi) a whisk to keep off flies, used in the East Indies, also CHOWRI [n CHOWRIES]
CHROMIDE	a tropical freshwater fish of South India [n -S]
CHROMIDES	CHROMIDE, a tropical freshwater fish of South India [n]
CHUKAR	(Hindi) an Indian partridge, also CHIKHOR, CHIKOR, CHUKOR [n -S]
CHUKARS	CHUKAR, (Hindi) an Indian partridge, also CHIKHOR, CHIKOR, CHUKOR [n]
CHUKKA	(Hindi) a period of play in polo, also CHUKKAR, CHUKKER [n -S]
CHUKKAR	(Hindi) a period of play in polo, also CHUKKA, CHUKKER [n -S]
CHUKKARS	CHUKKAR, (Hindi) a period of play in polo, also CHUKKA, CHUKKER [n]
CHUKKAS	CHUKKA, (Hindi) a period of play in polo, also CHUKKAR, CHUKKER [n]
CHUKKER	(Hindi) a period of play in polo, also CHUKKA, CHUKKAR [n -S]
CHUKKERS	CHUKKER, (Hindi) a period of play in polo, also CHUKKA, CHUKKAR [n]
CHUKOR	(Hindi) an Indian partridge, also CHIKHOR, CHIKOR, CHUKAR [n -S]
CHUKORS	CHUKOR, (Hindi) an Indian partridge, also CHIKHOR, CHIKOR, CHUKAR [n]
CHUPATI	(Hindi) a thin flat piece of unleavened bread, also CHAPATI, CHAPATTI, CHAPPATI, CHUPATTI, CHUPATTY [n -S]
CHUPATIS	CHUPATI, (Hindi) a thin flat piece of unleavened bread, also CHAPATI, CHAPATTI, CHAPPATI, CHUPATTI, CHUPATTY [n]
CHUPATTI	(Hindi) a thin flat piece of unleavened bread, also CHAPATI, CHAPATTI, CHAPPATI, CHUPATI, CHUPATTY [n -S]
CHUPATTIES	CHUPATTY, (Hindi) a thin flat piece of unleavened bread, also CHAPATI, CHAPATTI, CHAPPATI, CHUPATI, CHUPATTI [n]
CHUPATTIS	CHUPATTI, (Hindi) a thin flat piece of unleavened bread, also CHAPATI, CHAPATTI, CHAPPATI, CHUPATI, CHUPATTY [n]
CHUPATTY	(Hindi) a thin flat piece of unleavened bread, also CHAPATI, CHAPATTI, CHAPPATI, CHUPATI, CHUPATTI [n CHUPATTIES]
CHUPRASSIES	CHUPRASSY, (Urdu) an office messenger, a household attendant, also CHAPRASSI [n]
CHUPRASSY	(Urdu) an office messenger, a household attendant, also CHAPRASSI [n CHUPRASSIES]
CHURIDAR	(Hindi) as in churidar pyjamas, long tight-fitting trousers worn by Indian men and women [n -S]
CHURIDARS	(Hindi) tight-fitting trousers worn by Indian men and women [n]
CHURRUS	(Hindi) the resinous exudation of hashish, a narcotic and intoxicant, also CHARAS [n -ES]
CHURRUSES	CHURRUS, (Hindi) the resinous exudation of hashish, a narcotic and intoxicant, also CHARAS [n]
CHUTNEE	(Hindi) a warm or spicy condiment or pickle made in India, compounded of various vegetable substances, sweets, acids, etc., also CHUTNEY [n -S]
CHUTNEES	CHUTNEE, (Hindi) a warm or spicy condiment or pickle made in India, compounded of various vegetable substances, sweets, acids, etc., also CHUTNEY [n]
CHUTNEY	(Hindi) a warm or spicy condiment or pickle made in India, compounded of various vegetable substances, sweets, acids, etc., also CHUTNEE [n -S]
CHUTNEYS	CHUTNEY, (Hindi) a warm or spicy condiment or pickle made in India, compounded of various vegetable substances, sweets, acids, etc., also CHUTNEE [n]
CIRCAR	(Urdu) the state or government; the authorities, also SIRCAR, SIRKAR [n -S]
CIRCARS	CIRCAR, (Urdu) the state or government; the authorities, also SIRCAR, SIRKAR [n]
COBRA	(Portuguese) a venomous snake of India and Africa [n -S]
COBRAS	COBRA, (Portuguese) a venomous snake of India and Africa [n]
CONGEE	(Tamil) water in which rice has been boiled; rice or millet gruel [n -S] / to starch with congee, also CONJEE [v CONGEED, CONGEEING, CONGEES]
CONJEE	(Tamil) water in which rice has been boiled; rice or millet gruel [n -S] / to starch with conjee, also CONGEE [v CONJEED, CONJEEING, CONJEES]
CORNCOB	the cob or axis on which the kernels of Indian corn grow [n -S]
CORNCOBS	CORNCOB, the cob or axis on which the kernels of Indian corn grow [n]
CORNSTARCH	starch made from Indian corn, esp. a fine white flour used for puddings, etc. [n -ES]
CORNSTARCHES	CORNSTARCH, starch made from Indian corn, esp. a fine white flour used for puddings, etc. [n]
CORUNDUM	(Tamil) a mineral consisting of alumina, varieties including sapphire, ruby, emery [n -S]
CORUNDUMS	CORUNDUM, (Tamil) a mineral consisting of alumina, varieties including sapphire, ruby, emery [n]
COSS	(Hindi) a measure of distance in India, also KOS, KOSS [n -ES]
COSSES	COSS, (Hindi) a measure of distance in India, also KOS, KOSS [n]
COTWAL	(Hindi) the chief constable of an Indian town, also KOTWAL [n -S]
COTWALS	COTWAL, (Hindi) the chief constable of an Indian town, also KOTWAL [n]
COWAGE	(Hindi) a leguminous climbing plant with crooked pods covered with sharp stinging hairs, also COWHAGE, COWITCH [n -S]
COWAGES	COWAGE, (Hindi) a leguminous climbing plant with crooked pods covered with sharp stinging hairs, also COWHAGE, COWITCH [n]
COWHAGE	(Hindi) a leguminous climbing plant with crooked pods covered with sharp stinging hairs, also COWAGE, COWITCH [n -S]
COWHAGES	COWHAGE, (Hindi) a leguminous climbing plant with crooked pods covered with sharp stinging hairs, also COWAGE, COWITCH [n]
COWITCH	(Hindi) a leguminous climbing plant with crooked pods covered with sharp stinging hairs, also COWAGE, COWHAGE [n -ES]
COWITCHES	COWITCH, (Hindi) a leguminous climbing plant with crooked pods covered with sharp stinging hairs, also COWAGE, COWHAGE [n]
CRORE	(Hindi) an Indian unit of counting, ten million [n -S]
CROREPATI	in India, a person whose assets are worth at least one crore or a million rupees [n -S]
CROREPATIS	CROREPATI, in India, a person whose assets are worth at least one crore or a million rupees [n]
CRORES	CRORE, (Hindi) an Indian unit of counting, ten million [n]
CUMBERBUND	(Hindi) a waistband, a sash, also CUMMERBUND, KUMMERBUND [n -S]
CUMBERBUNDS	CUMBERBUND, (Hindi) a waistband, a sash, also CUMMERBUND, KUMMERBUND [n]
CUMMERBUND	(Hindi) a waistband, a sash, also CUMBERBUND, KUMMERBUND [n -S]
CUMMERBUNDS	CUMMERBUND, (Hindi) a waistband, a sash, also CUMBERBUND, KUMMERBUND [n]
CURRY	(Tamil) meat, fish, vegetables, etc., cooked with a mixture of strong spices and turmeric [n CURRIES] / to make a curry of [v CURRIED, CURRYING, CURRIES]
CUTCHA	(Hindi) made of dried mud, makeshift, also KACHA, KACHCHA, KUCHCHA, KUTCHA [adj]
CUTCHERIES	CUTCHERY, (Hindi) an Indian magistrate's office or courthouse, also CUTCHERRY, KACHAHARI, KACHAHRI, KACHERI [n]
CUTCHERRIES	CUTCHERRY, (Hindi) an Indian magistrate's office or courthouse, also CUTCHERY, KACHAHARI, KACHAHRI, KACHERI [n]
CUTCHERRY	(Hindi) an Indian magistrate's office or courthouse, also CUTCHERY, KACHAHARI, KACHAHRI, KACHERI [n CUTCHERRIES]
CUTCHERY	(Hindi) an Indian magistrate's office or courthouse, also CUTCHERRY, KACHAHARI, KACHAHRI, KACHERI [n CUTCHERIES]
DAAL	(Hindi) the pigeon pea, a pealike plant cultivated in India and the tropics, also DAL, DAHL, DHAL, DHOLL [n -S]
DAALS	DAAL, (Hindi) the pigeon pea, a pealike plant cultivated in India and the tropics, also DAL, DAHL, DHAL, DHOLL [n]
DABBA	(Hindi) in Indian cookery, a round metal box used to transport hot food [n -S]
DABBAS	DABBA, (Hindi) in Indian cookery, a round metal box used to transport hot food [n]
DACOIT	(Hindi) a member of an Indian robber gang, also DAKOIT [n -S]
DACOITAGE	(Hindi) robbery by dacoits, also DACOITY, DAKOITI, DAKOITY [n -S]
DACOITAGES	DACOITAGE, (Hindi) robbery by dacoits, also DACOITY, DAKOITI, DAKOITY [n]
DACOITIES	DACOITY, (Hindi) robbery by dacoits, also DACOITAGE, DAKOITI, DAKOITY [n]
DACOITS	DACOIT, (Hindi) a member of an Indian robber gang, also DAKOIT [n]
DACOITY	(Hindi) robbery by dacoits, also DACOITAGE, DAKOITI, DAKOITY [n DACOITIES]
DAFTAR	(Urdu) in India, an office, esp. a military orderly room [n -S]
DAFTARS	DAFTAR, (Urdu) in India, an office, esp. a military orderly room [n]
DAGABA	(Sinhalese) a Buddhist memorial shrine, also DAGOBA [n -S]
DAGABAS	DAGABA, (Sinhalese) a Buddhist memorial shrine, also DAGOBA [n]
DAGOBA	(Sinhalese) a Buddhist memorial shrine, also DAGABA [n -S]
DAGOBAS	DAGOBA, (Sinhalese) a Buddhist memorial shrine, also DAGABA [n]
DAHL	(Hindi) an Indian name for a lentil, also DAAL, DAL, DHAL, DHOLL [n -S]
DAHLS	DAHL, (Hindi) an Indian name for a lentil, also DAAL, DAL, DHAL, DHOLL [n]
DAK	(Hindi) the mail-post in India, also DAWK [n -S]
DAKOIT	(Hindi) a member of an Indian robber gang, also DACOIT [n -S]
DAKOITI	(Hindi) robbery by dacoits, also DACOITAGE, DACOITY, DAKOITY [n -S]
DAKOITIES	DAKOITY, (Hindi) robbery by dacoits, also DACOITAGE, DACOITY, DAKOITI [n]
DAKOITIS	DAKOITI, (Hindi) robbery by dacoits, also DACOITAGE, DACOITY, DAKOITY [n]
DAKOITS	DAKOIT, (Hindi) a member of an Indian robber gang, also DACOIT [n]
DAKOITY	(Hindi) robbery by dacoits, also DACOITAGE, DACOITY, DAKOITI [n DAKOITIES]
DAKS	DAK, (Hindi) the mail-post in India, also DAWK [n]
DAL	(Hindi) a kind of Indian edible pea, also DAAL, DAHL, DHAL, DHOLL [n -S]
DALS	DAL, (Hindi) a kind of Indian edible pea, also DAAL, DAHL, DHAL, DHOLL [n]
DANSAK	(Urdu) any of a variety of Indian dishes consisting of meat or vegetables braised with water or stock and lentils, also DHANSAK [n -S]
DANSAKS	DANSAK, (Urdu) any of a variety of Indian dishes consisting of meat or vegetables braised with water or stock and lentils, also DHANSAK [n]
DARBAR	the court of a native ruler in India, also DURBAR [n -S]
DARBARS	DARBAR, the court of a native ruler in India, also DURBAR [n]
DARGA	(Hindi) the tomb of a Muslim saint, also DARGAH, DURGAH [n -S]
DARGAS	DARGA, (Hindi) the tomb of a Muslim saint, also DARGAH, DURGAH [n]
DARI	(Arabic) Indian millet, also DHOORA, DHOURRA, DHURRA, DOURA, DOURAH, DURA, DURR, DURRA [n -S]
DARIS	DARI, (Arabic) Indian millet, also DHOORA, DHOURRA, DHURRA, DOURA, DOURAH, DURA, DURR, DURRA [n]
DAROGA	(Urdu) in India, a manager, also DAROGHA [n -S]
DAROGAS	DAROGA, (Urdu) in India, a manager, also DAROGHA [n]
DAROGHA	(Urdu) in India, a manager, also DAROGA [n -S]
DAROGHAS	DAROGHA, (Urdu) in India, a manager, also DAROGA [n]
DARSHAN	(Hindi) a blessing conferred by touching or seeing a holy person [n -S]
DARSHANS	DARSHAN, (Hindi) a blessing conferred by touching or seeing a holy person [n]
DARZI	(Hindi) a Hindu tailor, also DURZI [n -S]
DARZIS	DARZI, (Hindi) a Hindu tailor, also DURZI [n]
DATURA	(Hindi) a genus of solanaceous plants, with large funnel-shaped flowers [n -S]
DATURAS	DATURA, (Hindi) a genus of solanaceous plants, with large funnel-shaped flowers [n]
DAWK	(Hindi) the mail-post in India, also DAK [n -S]
DAWKS	DAWK, (Hindi) the mail-post in India, also DAK [n]
DEEWAN	(Urdu) an official in India [n -S]
DEEWANS	DEEWAN, (Urdu) an official in India [n]
DEEYA	(Hindi) a small oil lamp used in Hindu worship, esp. at Diwali, also DIYA [n -S]
DEEYAS	DEEYA, (Hindi) a small oil lamp used in Hindu worship, esp. at Diwali, also DIYA [n]
DEODAR	(Sanskrit) an East Indian cedar, also DEODARA [n -S]
DEODARA	(Sanskrit) an East Indian cedar, also DEODAR [n -S]
DEODARAS	DEODARA, (Sanskrit) an East Indian cedar, also DEODAR [n]
DEODARS	DEODAR, (Sanskrit) an East Indian cedar, also DEODARA [n]
DESHI	(Hinglish) a person of Indian, Pakistani or Bangladeshi birth who lives abroad, also DESI [n -S]
DESHIS	DESHI, (Hinglish) a person of Indian, Pakistani or Bangladeshi birth who lives abroad, also DESI [n]
DESI	(Hinglish) a person of Indian, Pakistani or Bangladeshi birth who lives abroad, also DESHI [n -S]
DESIS	DESI, (Hinglish) a person of Indian, Pakistani or Bangladeshi birth who lives abroad, also DESHI [n]
DETENU	(French) a (male) prisoner, esp. a political prisoner in India [n -S]
DETENUE	(French) a (female) prisoner, esp. a political prisoner in India [n -S]
DETENUES	DETENUE, (French) a (female) prisoner, esp. a political prisoner in India [n]
DETENUS	DETENU, (French) a (male) prisoner, esp. a political prisoner in India [n]
DEV	(Sanskrit) a Hindu god, also DEVA [n -S]
DEVA	(Sanskrit) a Hindu god, also DEV [n -S]
DEVANAGARI	(Sanskrit) the character in which Sanskrit is usually printed, also NAGARI [n -S]
DEVANAGARIS	DEVANAGARI, (Sanskrit) the character in which Sanskrit is usually printed, also NAGARI [n]
DEVAS	DEVA, (Sanskrit) a Hindu god, also DEV [n]
DEVI	(Sanskrit) a Hindu goddess [n -S]
DEVIS	DEVI, (Sanskrit) a Hindu goddess [n]
DEVS	DEV, (Sanskrit) a Hindu god, also DEVA [n]
DEWAN	(Urdu) in India, a financial minister, also DEEWAN, DIWAN [n -S]
DEWANI	(Urdu) the office of dewan, also DEWANNY [n -S]
DEWANIS	DEWANI, (Urdu) the office of dewan, also DEWANNY [n]
DEWANNIES	DEWANNY, (Urdu) the office of dewan, also DEWANI [n]
DEWANNY	(Urdu) the office of dewan, also DEWANI [n DEWANNIES]
DEWANS	DEWAN, (Urdu) in India, a financial minister, also DEEWAN, DIWAN [n]
DHABA	(Hindi) (in India) a roadside cafe or food stall [n -S]
DHABAS	DHABA, (Hindi) (in India) a roadside cafe or food stall [n]
DHAK	(Hindi) a leguminous tree of eastern India and Myanmar, with showy orange or red flowers [n -S]
DHAKS	DHAK, (Hindi) a leguminous tree of eastern India and Myanmar, with showy orange or red flowers [n]
DHAL	(Hindi) an Indian name for a lentil, also DAAL, DAHL, DAL, DHOLL [n -S]
DHALS	DHAL, (Hindi) an Indian name for a lentil, also DAAL, DAHL, DAL, DHOLL [n]
DHAMMA	(Sanskrit) custom or law regarded as duty; the basic principles of cosmic or individual existence, also DHARMA [n -S]
DHAMMAS	DHAMMA, (Sanskrit) custom or law regarded as duty; the basic principles of cosmic or individual existence, also DHARMA [n]
DHANSAK	(Urdu) any of a variety of Indian dishes consisting of meat or vegetables braised with water or stock and lentils, also DANSAK [n -S]
DHANSAKS	DHANSAK, (Urdu) any of a variety of Indian dishes consisting of meat or vegetables braised with water or stock and lentils, also DANSAK [n]
DHARMA	(Sanskrit) custom or law regarded as duty; the basic principles of cosmic or individual existence, also DHAMMA [n -S]
DHARMAS	DHARMA, (Sanskrit) custom or law regarded as duty; the basic principles of cosmic or individual existence, also DHAMMA [n]
DHARMIC	(Sanskrit) of or like dharma [adj]
DHARMSALA	(Hindi) a building having a religious or charitable purpose, a free or cheap lodging for travellers, also DHARMSHALA [n -S]
DHARMSALAS	DHARMSALA, (Hindi) a building having a religious or charitable purpose, a free or cheap lodging for travellers, also DHARMSHALA [n]
DHARMSHALA	(Hindi) a building having a religious or charitable purpose, a free or cheap lodging for travellers, also DHARMSALA [n -S]
DHARMSHALAS	DHARMSHALA, (Hindi) a building having a religious or charitable purpose, a free or cheap lodging for travellers, also DHARMSALA [n]
DHARNA	(Hindi) a method of collecting a debt in which the person who is owed money sits on the debtor's doorstep until payment is made, or the debtor starves to death, also DHURNA [n -S]
DHARNAS	DHARNA, (Hindi) a method of collecting a debt in which the person who is owed money sits on the debtor's doorstep until payment is made, or the debtor starves to death, also DHURNA [n]
DHOBI	(Hindi) an Indian washerwoman [n -S]
DHOBIS	DHOBI, (Hindi) an Indian washerwoman [n]
DHOL	(Hindi) a large cylindrical drum, used in Indian music [n -S]
DHOLAK	(Hindi) a two-headed drum [n -S]
DHOLAKS	DHOLAK, (Hindi) a two-headed drum [n]
DHOLE	an Indian wild dog [n -S]
DHOLES	DHOLE, an Indian wild dog [n]
DHOLL	(Hindi) an Indian name for lentil, also DAAL, DAHL, DAL, DHAL [n -S]
DHOLLS	DHOLL, (Hindi) an Indian name for lentil, also DAAL, DAHL, DAL, DHAL [n]
DHOLS	DHOL, (Hindi) a large cylindrical drum, used in Indian music [n]
DHOOLIES	DHOOLY, (Hindi) a litter or palanquin, also DOOLEE, DOOLIE, DOOLY [n]
DHOOLY	(Hindi) a litter or palanquin, also DOOLEE, DOOLIE, DOOLY [n DHOOLIES]
DHOORA	(Arabic) Indian millet, also DARI, DHOURRA, DHURRA, DOURA, DOURAH, DURA, DURR, DURRA [n -S]
DHOORAS	DHOORA, (Arabic) Indian millet, also DARI, DHOURRA, DHURRA, DOURA, DOURAH, DURA, DURR, DURRA [n]
DHOOTI	(Hindi) a loincloth worn by Indian men, also DHOOTIE, DHOTI, DHUTI [n -S]
DHOOTIE	(Hindi) a loincloth worn by Indian men, also DHOOTI, DHOTI, DHUTI [n -S]
DHOOTIES	DHOOTIE, (Hindi) a loincloth worn by Indian men, also DHOOTI, DHOTI, DHUTI [n]
DHOOTIS	DHOOTI, (Hindi) a loincloth worn by Indian men, also DHOOTIE, DHOTI, DHUTI [n]
DHOTI	(Hindi) a loincloth worn by Indian men, also DHOOTI, DHOOTIE, DHUTI [n -S]
DHOTIS	DHOTI, (Hindi) a loincloth worn by Indian men, also DHOOTI, DHOOTIE, DHUTI [n]
DHOURRA	(Arabic) Indian millet, also DARI, DHOORA, DHURRA, DOURA, DOURAH, DURA, DURR, DURRA [n -S]
DHOURRAS	DHOURRA, (Arabic) Indian millet, also DARI, DHOORA, DHURRA, DOURA, DOURAH, DURA, DURR, DURRA [n]
DHURNA	(Hindi) a method of collecting a debt in which the person who is owed money sits on the debtor's doorstep until payment is made, or the debtor starves to death, also DHARNA [n -S]
DHURNAS	DHURNA, (Hindi) a method of collecting a debt in which the person who is owed money sits on the debtor's doorstep until payment is made, or the debtor starves to death, also DHARNA [n]
DHURRA	(Arabic) Indian millet, also DARI, DHOORA, DHOURRA, DOURA, DOURAH, DURA, DURR, DURRA [n -S]
DHURRAS	DHURRA, (Arabic) Indian millet, also DARI, DHOORA, DHOURRA, DOURA, DOURAH, DURA, DURR, DURRA [n]
DHURRIE	(Hindi) an Indian cotton rug, also DURRIE [n -S]
DHURRIES	DHURRIE, (Hindi) an Indian cotton rug, also DURRIE [n]
DHUTI	(Hindi) a loincloth worn by Indian men, also DHOOTI, DHOOTIE, DHOTI [n -S]
DHUTIS	DHUTI, (Hindi) a loincloth worn by Indian men, also DHOOTI, DHOOTIE, DHOTI [n]
DHYANA	(Sanskrit) a profound meditation in Hinduism [n -S]
DHYANAS	DHYANA, (Sanskrit) a profound meditation in Hinduism [n]
DIWAN	(Urdu) in India, a financial minister, also DEEWAN, DEWAN [n -S]
DIWANS	DIWAN, (Urdu) in India, a financial minister, also DEEWAN, DEWAN [n]
DIXIE	(Hindi) a military cooking-pot, also DIXY [n -S]
DIXIES	DIXIE, (Hindi) a military cooking-pot, also DIXY [n]
DIXY	(Hindi) a military cooking-pot, also DIXIE [n DIXIES]
DIYA	(Hindi) a small oil lamp used in Hindu worship, esp. at Diwali, also DEEYA [n -S]
DIYAS	DIYA, (Hindi) a small oil lamp used in Hindu worship, esp. at Diwali, also DEEYA [n]
DOAB	(Urdu) a tongue or tract of land included between two rivers; as, the doab between the Ganges and the Jumna [n -S]
DOABS	DOAB, (Urdu) a tongue or tract of land included between two rivers; as, the doab between the Ganges and the Jumna [n]
DOBHASH	(Hindi) an interpreter [n -ES]
DOBHASHES	DOBHASH, (Hindi) an interpreter [n]
DOOB	(Hindi) dog's tooth grass, prized as food for cattle [n -S]
DOOBS	DOOB, (Hindi) dog's tooth grass, prized as food for cattle [n]
DOOLALLY	(Hindi) crazy, deranged [adj]
DOOLEE	(Hindi) a litter or palanquin, also DHOOLY, DOOLIE, DOOLY [n -S]
DOOLEES	DOOLEE, (Hindi) a litter or palanquin, also DHOOLY, DOOLIE, DOOLY [n]
DOOLIE	(Hindi) a litter or palanquin, also DHOOLY, DOOLEE, DOOLY [n -S]
DOOLIES	DOOLY, (Hindi) a litter or palanquin, also DHOOLY, DOOLEE, DOOLIE [n]
DOOLY	(Hindi) a litter or palanquin, also DHOOLY, DOOLEE, DOOLIE [n DOOLIES]
DOOSRA	(Urdu) a delivery bowled by an off-spinner [n -S]
DOOSRAS	DOOSRA, (Urdu) a delivery bowled by an off-spinner [n]
DOPATTA	(Hindi) a silk or muslin shawl, also DUPATTA [n DOPATTAS or DOPATTE]
DOPATTAS	DOPATTA, (Hindi) a silk or muslin shawl, also DUPATTA [n]
DOPATTE	DOPATTA, (Hindi) a silk or muslin shawl, also DUPATTA [n]
DOPIAZA	an Indian dish, meat or fish in onion sauce [n -S]
DOPIAZAS	DOPIAZA, an Indian dish, meat or fish in onion sauce [n]
DOSA	(Hindi) an Indian pancake made from rice flour [n DOSAI or DOSAS]
DOSAI	DOSA, (Hindi) an Indian pancake made from rice flour [n]
DOSAS	DOSA, (Hindi) an Indian pancake made from rice flour [n]
DOSHA	(Sanskrit) each of three energies believed in Ayurveda to circulate in the body [n -S]
DOSHAS	DOSHA, (Sanskrit) each of three energies believed in Ayurveda to circulate in the body [n]
DOURA	(Arabic) Indian millet, also DARI, DHOORA, DHOURRA, DHURRA, DOURAH, DURA, DURR, DURRA [n -S]
DOURAH	(Arabic) Indian millet, also DARI, DHOORA, DHOURRA, DHURRA, DOURA, DURA, DURR, DURRA [n -S]
DOURAHS	DOURAH, (Arabic) Indian millet, also DARI, DHOORA, DHOURRA, DHURRA, DOURA, DURA, DURR, DURRA [n]
DOURAS	DOURA, (Arabic) Indian millet, also DARI, DHOORA, DHOURRA, DHURRA, DOURAH, DURA, DURR, DURRA [n]
DROGER	(Dutch) a W. Indian coasting vessel, with long masts and lateen sails, also DROGHER [n -S]
DROGERS	DROGER, (Dutch) a W. Indian coasting vessel, with long masts and lateen sails, also DROGHER [n]
DROGHER	(Dutch) a W. Indian coasting vessel, with long masts and lateen sails, also DROGER [n -S]
DROGHERS	DROGHER, (Dutch) a W. Indian coasting vessel, with long masts and lateen sails, also DROGER [n]
DUHKHA	(Sanskrit) suffering due to the desire for permanence, also DUKKHA [n -S]
DUHKHAS	DUHKHA, (Sanskrit) suffering due to the desire for permanence, also DUKKHA [n]
DUKKHA	(Sanskrit) suffering due to the desire for permanence, also DUHKHA [n -S]
DUKKHAS	DUKKHA, (Sanskrit) suffering due to the desire for permanence, also DUHKHA [n]
DUNGAREE	(Hindi) a coarse cotton fabric, trousers made from this [n -S]
DUNGAREES	DUNGAREE, (Hindi) a coarse cotton fabric, trousers made from this [n]
DUPATTA	(Hindi) a silk or muslin shawl, also DOPATTA [n DUPATTAS or DUPATTE]
DUPATTAS	DUPATTA, (Hindi) a silk or muslin shawl, also DOPATTA [n]
DUPATTE	DUPATTA, (Hindi) a silk or muslin shawl, also DOPATTA [n]
DURA	(Arabic) Indian millet, also DARI, DHOORA, DHOURRA, DHURRA, DOURA, DOURAH, DURR, DURRA [n -S]
DURAS	DURA, (Arabic) Indian millet, also DARI, DHOORA, DHOURRA, DHURRA, DOURA, DOURAH, DURR, DURRA [n]
DURBAR	(Urdu) the court of a native ruler in India, also DARBAR [n -S]
DURBARS	DURBAR, (Urdu) the court of a native ruler in India, also DARBAR [n]
DURR	(Arabic) Indian millet, also DARI, DHOORA, DHOURRA, DHURRA, DOURA, DOURAH, DURA, DURRA [n -S]
DURRA	(Arabic) Indian millet, also DARI, DHOORA, DHOURRA, DHURRA, DOURA, DOURAH, DURA, DURR [n -S]
DURRAS	DURRA, (Arabic) Indian millet, also DARI, DHOORA, DHOURRA, DHURRA, DOURA, DOURAH, DURA, DURR [n]
DURRIE	(Hindi) an Indian cotton rug, also DHURRIE [n -S]
DURRIES	DURRIE, (Hindi) an Indian cotton rug, also DHURRIE [n]
DURRS	DURR, (Arabic) Indian millet, also DARI, DHOORA, DHOURRA, DHURRA, DOURA, DOURAH, DURA, DURRA [n]
DURZI	(Hindi) a Hindu tailor, also DARZI [n -S]
DURZIS	DURZI, (Hindi) a Hindu tailor, also DARZI [n]
DVANDVA	(Sanskrit) a compound word in which neither element is subordinated to the other, e.g. tragicomedy [n -S]
DVANDVAS	DVANDVA, (Sanskrit) a compound word in which neither element is subordinated to the other, e.g. tragicomedy [n]
EKKA	(Hindi) a small one-horse carriage [n -S]
EKKAS	EKKA, (Hindi) a small one-horse carriage [n]
ENTELLUS	(Latin) an East Indian long-tailed bearded monkey, remarkable for the cap-like arrangement of the hair on the head [n -ES]
ENTELLUSES	ENTELLUS, (Latin) an East Indian long-tailed bearded monkey, remarkable for the cap-like arrangement of the hair on the head [n]
FAKEER	(Arabic) a Hindu ascetic, also FAKIR, FAQIR, FAQUIR [n -S]
FAKEERS	FAKEER, (Arabic) a Hindu ascetic, also FAKIR, FAQIR, FAQUIR [n]
FAKIR	(Arabic) a Hindu ascetic, also FAKEER, FAQIR, FAQUIR [n -S]
FAKIRISM	religious asceticism in India [n -S]
FAKIRISMS	FAKIRISM, religious asceticism in India [n]
FAKIRS	FAKIR, (Arabic) a Hindu ascetic, also FAKEER, FAQIR, FAQUIR [n]
FAQIR	(Arabic) a Hindu ascetic, also FAKEER, FAKIR, FAQUIR [n -S]
FAQIRS	FAQIR, (Arabic) a Hindu ascetic, also FAKEER, FAKIR, FAQUIR [n]
FAQUIR	(Arabic) a Hindu ascetic, also FAKEER, FAKIR, FAQIR [n -S]
FAQUIRS	FAQUIR, (Arabic) a Hindu ascetic, also FAKEER, FAKIR, FAQIR [n]
FENI	(Hindi) an alcoholic spirit made from coconuts, also FENNY [n -S]
FENIS	FENI, (Hindi) an alcoholic spirit made from coconuts, also FENNY [n]
FILMI	(Hinglish) relating to films or the cinema industry [n -S]
FILMIS	FILMI, (Hinglish) relating to films or the cinema industry [n]
FLATHEAD	any of various species of edible flat-skulled fish of the Pacific and Indian Oceans [n -S]
FLATHEADS	FLATHEAD, any of various species of edible flat-skulled fish of the Pacific and Indian Oceans [n]
FRESHIE	(Hinglish) a new immigrant to the UK from Asian countries [n -S]
FRESHIES	FRESHIE, (Hinglish) a new immigrant to the UK from Asian countries [n]
FROGMOUTH	one of several species of Asiatic and East Indian birds, so called from their very broad, flat bills [n -S]
FROGMOUTHS	FROGMOUTH, one of several species of Asiatic and East Indian birds, so called from their very broad, flat bills [n]
GADDI	(Marathi) the cushioned throne of an Indian ruler, also GADI [n -S]
GADDIS	GADDI, (Marathi) the cushioned throne of an Indian ruler, also GADI [n]
GADI	(Marathi) the cushioned throne of an Indian ruler, also GADDI [n -S]
GADIS	GADI, (Marathi) the cushioned throne of an Indian ruler, also GADDI [n]
GALANGA	the aromatic rootstock of certain East Indian plants of the ginger family, also GALANGAL, GALENGALE, GALINGALE [n -S]
GALANGAL	the aromatic rootstock of certain East Indian plants of the ginger family, also GALANGA, GALENGALE, GALINGALE [n -S]
GALANGALS	GALANGAL, the aromatic rootstock of certain East Indian plants of the ginger family, also GALANGA, GALENGALE, GALINGALE [n]
GALANGAS	GALANGA, the aromatic rootstock of certain East Indian plants of the ginger family, also GALANGAL, GALENGALE, GALINGALE [n]
GALENGALE	the aromatic rootstock of certain East Indian plants of the ginger family, also GALANGA, GALANGAL, GALINGALE [n -S]
GALENGALES	GALENGALE, the aromatic rootstock of certain East Indian plants of the ginger family, also GALANGA, GALANGAL, GALINGALE [n]
GALINGALE	the aromatic rootstock of certain East Indian plants of the ginger family, also GALANGA, GALANGAL, GALENGALE [n -S]
GALINGALES	GALINGALE, the aromatic rootstock of certain East Indian plants of the ginger family, also GALANGA, GALANGAL, GALENGALE [n]
GANJA	(Hindi) cannabis used for smoking, also GANJAH [n -S]
GANJAH	(Hindi) cannabis used for smoking, also GANJA [n -S]
GANJAHS	GANJAH, (Hindi) cannabis used for smoking, also GANJA [n]
GANJAS	GANJA, (Hindi) cannabis used for smoking, also GANJAH [n]
GARIAL	(Hindi) an Indian crocodile, also GAVIAL, GHARIAL [n -S]
GARIALS	GARIAL, (Hindi) an Indian crocodile, also GAVIAL, GHARIAL [n]
GARJAN	(Hindi) a thin balsam or wood oil derived from an East Indian tree, also GURJUN [n -S]
GARJANS	GARJAN, (Hindi) a thin balsam or wood oil derived from an East Indian tree, also GURJUN [n]
GARUDA	(Sanskrit) a Hindu demigod, part man, part bird [n -S]
GARUDAS	GARUDA, (Sanskrit) a Hindu demigod, part man, part bird [n]
GATH	in Indian music, the second section of a raga [n -S]
GATHS	GATH, in Indian music, the second section of a raga [n]
GAUR	(Hindi) a kind of wild ox, aka seladang [n -S]
GAURS	GAUR, (Hindi) a kind of wild ox, aka seladang [n]
GAVIAL	(Hindi) an Indian crocodile with a long snout, also GARIAL, GHARIAL [n -S]
GAVIALS	GAVIAL, (Hindi) an Indian crocodile with a long snout, also GARIAL, GHARIAL [n]
GAYAL	(Hindi) an Indian domesticated ox, also GYAL [n -S]
GAYALS	GAYAL, (Hindi) an Indian domesticated ox, also GYAL [n]
GHARIAL	(Hindi) an Indian crocodile, also GAVIAL, GARIAL [n -S]
GHARIALS	GHARIAL, (Hindi) an Indian crocodile, also GAVIAL, GARIAL [n]
GHARRI	(Hindi) in India, a wheeled vehicle for hire, also GHARRY [n -S]
GHARRIES	GHARRY, (Hindi) in India, a wheeled vehicle for hire, also GHARRI [n]
GHARRIS	GHARRI, (Hindi) in India, a wheeled vehicle for hire, also GHARRY [n]
GHARRY	(Hindi) in India, a wheeled vehicle for hire, also GHARRI [n GHARRIES]
GHAT	(Hindi) in India, a landing stage; a place for cremation, also GHAUT [n -S]
GHATS	GHAT, (Hindi) in India, a landing stage; a place for cremation, also GHAUT [n]
GHAUT	(Hindi) in India, a landing stage; a place for cremation, also GHAT [n -S]
GHAUTS	GHAUT, (Hindi) in India, a landing stage; a place for cremation, also GHAT [n]
GHEE	(Hindi) a kind of liquid butter, also GHI [n -S]
GHEES	GHEE, (Hindi) a kind of liquid butter, also GHI [n]
GHERAO	(Hindi) in India, the surrounding or trapping of a person, e.g. an employer in a room or building, till demands are met [n -S] / to carry out such an action [v GHERAOED, GHERAOING, GHERAOES or GHERAOS]
GHUBAR	as in ghubar numeral, any of a set of numerals forming the stage between ancient Hindu numerals and present-day Arabic numerals, also GOBAR [adj]
GINGAL	(Hindi) a large Chinese or Indian swivel-musket, also GINGALL, JINGAL, JINGALL [n -S]
GINGALL	(Hindi) a large Chinese or Indian swivel-musket, also GINGAL, JINGAL, JINGALL [n -S]
GINGALLS	GINGALL, (Hindi) a large Chinese or Indian swivel-musket, also GINGAL, JINGAL, JINGALL [n]
GINGALS	GINGAL, (Hindi) a large Chinese or Indian swivel-musket, also GINGALL, JINGAL, JINGALL [n]
GINGELI	(Hindi) the sesame seed or its oil, also GINGELEY, GINGELLI, GINGELLY, GINGELY, GINGILI, GINGILLI, JINJILI [n GINGELIS or GINGELIES]
GINGELIES	GINGELY, (Hindi) the sesame seed or its oil, also GINGELEY, GINGELI, GINGELLI, GINGELLY, GINGILI, GINGILLI, JINJILI [n]
GINGELIS	GINGELI, (Hindi) the sesame seed or its oil, also GINGELEY, GINGELLI, GINGELLY, GINGELY, GINGILI, GINGILLI, JINJILI [n]
GINGELLI	(Hindi) the sesame seed or its oil, also GINGELEY, GINGELI, GINGELLY, GINGELY, GINGILI, GINGILLI, JINJILI [n -S]
GINGELLIES	GINGELLY, (Hindi) the sesame seed or its oil, also GINGELEY, GINGELI, GINGELLI, GINGELY, GINGILI, GINGILLI, JINJILI [n]
GINGELLIS	GINGELLI, (Hindi) the sesame seed or its oil, also GINGELEY, GINGELI, GINGELLY, GINGELY, GINGILI, GINGILLI, JINJILI [n]
GINGELLY	(Hindi) the sesame seed or its oil, also GINGELEY, GINGELI, GINGELLI, GINGELY, GINGILI, GINGILLI, JINJILI [n GINGELLIES]
GINGELY	(Hindi) the sesame seed or its oil, also GINGELEY, GINGELI, GINGELLI, GINGELLY, GINGILI, GINGILLI, JINJILI [n GINGELIES]
GINGILI	(Hindi) the sesame seed or its oil, also GINGELEY, GINGELI, GINGELLI, GINGELLY, GINGELY, GINGILLI, JINJILI [n -S]
GINGILIS	GINGILI, (Hindi) the sesame seed or its oil, also GINGELEY, GINGELI, GINGELLI, GINGELLY, GINGELY, GINGILLI, JINJILI [n]
GINGILLI	(Hindi) the sesame seed or its oil, also GINGELEY, GINGELI, GINGELLI, GINGELLY, GINGELY, GINGILI, JINJILI [n -S]
GINGILLIS	GINGILLI, (Hindi) the sesame seed or its oil, also GINGELEY, GINGELI, GINGELLI, GINGELLY, GINGELY, GINGILI, JINJILI [n]
GOBAR	as in gobar numeral, any of a set of numerals forming the stage between ancient Hindu numerals and present-day Arabic numerals, also GHUBAR [adj]
GOBI	(Hindi) a cabbage or cauliflower [n -S]
GOBIS	GOBI, (Hindi) a cabbage or cauliflower [n]
GOLCONDA	(Hindi) a source of great wealth [n -S]
GOLCONDAS	GOLCONDA, (Hindi) a source of great wealth [n]
GOONDA	(Hindi) a hired thug, esp. one in the hire of a political party [n -S]
GOONDAS	GOONDA, (Hindi) a hired thug, esp. one in the hire of a political party [n]
GOOR	(Hindi) an unrefined cane sugar, also GUR [n -S]
GOORAL	an Indian goat antelope resembling the chamois, also GORAL [n -S]
GOORALS	GOORAL, an Indian goat antelope resembling the chamois, also GORAL [n]
GOOROO	(Hindi) a Hindu spiritual teacher, also GURU [n -S]
GOOROOS	GOOROO, (Hindi) a Hindu spiritual teacher, also GURU [n]
GOORS	GOOR, (Hindi) an unrefined cane sugar, also GUR [n]
GOPURA	(Sanskrit) in South India, a pyramidal tower over the gateway of a temple, also GOPURAM [n -S]
GOPURAM	(Sanskrit) in South India, a pyramidal tower over the gateway of a temple, also GOPURA [n -S]
GOPURAMS	GOPURAM, (Sanskrit) in South India, a pyramidal tower over the gateway of a temple, also GOPURA [n]
GOPURAS	GOPURA, (Sanskrit) in South India, a pyramidal tower over the gateway of a temple, also GOPURAM [n]
GORA	(Hinglish) a white or fair-skinned male [n -S]
GORAL	an Indian goat antelope resembling the chamois, also GOORAL [n -S]
GORALS	GORAL, an Indian goat antelope resembling the chamois, also GOORAL [n]
GORAS	GORA, (Hinglish) a white or fair-skinned male [n]
GORI	(Hinglish) a white or fair-skinned female [n -S]
GORIS	GORI, (Hinglish) a white or fair-skinned female [n]
GOSHT	(Hindi) in Indian cookery, meat [n -S]
GOSHTS	GOSHT, (Hindi) in Indian cookery, meat [n]
GUAR	(Hindi) a legume grown for forage and its seeds which yield guar gum [n -S]
GUARS	GUAR, (Hindi) a legume grown for forage and its seeds which yield guar gum [n]
GUNNIES	GUNNY, (Hindi) a coarse jute fabric [n]
GUNNY	(Hindi) a coarse jute fabric [n GUNNIES]
GURDWARA	(Punjabi) a Sikh place of worship which includes a place where the scripture is housed [n -S]
GURDWARAS	GURDWARA, (Punjabi) a Sikh place of worship which includes a place where the scripture is housed [n]
GURJUN	(Hindi) a thin balsam or wood oil derived from an East Indian tree, also GARJAN [n -S]
GURJUNS	GURJUN, (Hindi) a thin balsam or wood oil derived from an East Indian tree, also GARJAN [n]
GURRAH	(Hindi) a coarse Indian muslin [n -S]
GURRAHS	GURRAH, (Hindi) a coarse Indian muslin [n]
GURU	(Hindi) a Hindu spiritual teacher, also GOOROO [n -S]
GURUS	GURU, (Hindi) a Hindu spiritual teacher, also GOOROO [n]
GYAL	(Hindi) an Indian domesticated ox, also GAYAL [n -S]
GYALS	GYAL, (Hindi) an Indian domesticated ox, also GAYAL [n]
GYAN	(Hindi) knowledge [n -S]
GYANI	(Sanskrit) a scholar in the Sikh religion, especially one who leads the prayers of a congregation [n -S]
GYANIS	GYANI, (Sanskrit) a scholar in the Sikh religion, especially one who leads the prayers of a congregation [n]
GYANS	GYAN, (Hindi) knowledge [n]
GYMKHANA	(Urdu) a sporting contest, esp. one involving riding or driving skills [n -S]
GYMKHANAS	GYMKHANA, (Urdu) a sporting contest, esp. one involving riding or driving skills [n]
GYMNOSOPH	one of a sect of naked ascetics of ancient India, also GYMNOSOPHIST [n -S]
GYMNOSOPHIST	one of a sect of naked ascetics of ancient India, also GYMNOSOPH [n -S]
GYMNOSOPHISTS	GYMNOSOPHIST, one of a sect of naked ascetics of ancient India, also GYMNOSOPH [n]
GYMNOSOPHS	GYMNOSOPH, one of a sect of naked ascetics of ancient India, also GYMNOSOPHIST [n]
HALWA	(Hindi) a sweet Indian dish [n -S]
HALWAS	HALWA, (Hindi) a sweet Indian dish [n]
HANUMAN	(Hindi) an East Indian monkey with a bristly face [n -S]
HANUMANS	HANUMAN, (Hindi) an East Indian monkey with a bristly face [n]
HARAMDA	(Hindi) an illegitimate male, also HARAMZADA [n -S]
HARAMDAS	HARAMDA, (Hindi) an illegitimate male, also HARAMZADA [n]
HARAMDI	(Hindi) an illegitimate female, also HARAMZADI [n -S]
HARAMDIS	HARAMDI, (Hindi) an illegitimate female, also HARAMZADI [n]
HARAMZADA	(Hinglish) an illegitimate male, also HARAMDA [n -S]
HARAMZADAS	HARAMZADA, (Hinglish) an illegitimate male, also HARAMDA [n]
HARAMZADI	(Hinglish) an illegitimate female, also HARAMDI [n -S]
HARAMZADIS	HARAMZADI, (Hinglish) an illegitimate female, also HARAMDI [n]
HARIANA	(Punjabi) a breed of Indian cattle [n -S]
HARIANAS	HARIANA, (Punjabi) a breed of Indian cattle [n]
HARIJAN	(Sanskrit) in India, a member of the untouchable caste [n -S]
HARIJANS	HARIJAN, (Sanskrit) in India, a member of the untouchable caste [n]
HARTAL	(Hindi) in India, a general strike [n -S]
HARTALS	HARTAL, (Hindi) in India, a general strike [n]
HATHA	(Sanskrit) as in hatha yoga, a form of yoga [adj]
HAVILDAR	(Urdu) the rank of sergeant in the Indian army [n -S]
HAVILDARS	HAVILDAR, (Urdu) the rank of sergeant in the Indian army [n]
HING	(Hindi) a foul-smelling gum resin [n -S]
HINGS	HING, (Hindi) a foul-smelling gum resin [n]
HOOKA	(Urdu) a pipe with a long, flexible stem, so arranged that the smoke is cooled by being made to pass through water, also HOOKAH [n -S]
HOOKAH	(Urdu) a pipe with a long, flexible stem, so arranged that the smoke is cooled by being made to pass through water, also HOOKA [n -S]
HOOKAHS	HOOKAH, (Urdu) a pipe with a long, flexible stem, so arranged that the smoke is cooled by being made to pass through water, also HOOKA [n]
HOOKAS	HOOKA, (Urdu) a pipe with a long, flexible stem, so arranged that the smoke is cooled by being made to pass through water, also HOOKAH [n]
HUMA	(Urdu) a mythical bird similar to the phoenix, supposed to bring luck to any person over whom it hovers on its restless flights [n -S]
HUMAS	HUMA, (Urdu) a mythical bird similar to the phoenix, supposed to bring luck to any person over whom it hovers on its restless flights [n]
HUZOOR	(Urdu) an Indian potentate, a title used by Indians in respectful address [n -S]
HUZOORS	HUZOOR, (Urdu) an Indian potentate, a title used by Indians in respectful address [n]
ILLIPE	(Tamil) the mahwa tree, also ILLUPI [n -S]
ILLIPES	ILLIPE, (Tamil) the mahwa tree, also ILLUPI [n]
ILLUPI	(Tamil) the mahwa tree, also ILLIPE [n -S]
ILLUPIS	ILLUPI, (Tamil) the mahwa tree, also ILLIPE [n]
INDIAS	INDIA, (in international radio communication) a code word for the letter i [n]
INQILAB	(Urdu) in India, Pakistan etc., a revolution [n -S]
INQILABS	INQILAB, (Urdu) in India, Pakistan etc., a revolution [n]
ITCHWEED	a flower, Indian pokeweed [n -S]
ITCHWEEDS	ITCHWEED, a flower, Indian pokeweed [n]
IZZAT	(Urdu) honour, reputation, prestige [n -S]
IZZATS	IZZAT, (Urdu) honour, reputation, prestige [n]
JACKFRUIT	an East Indian tree of the breadfruit family, also JAK, JAKFRUIT [n -S]
JACKFRUITS	JACKFRUIT, an East Indian tree of the breadfruit family, also JAK, JAKFRUIT [n]
JACONET	(Hindi) a kind of thin cotton fabric, esp. with one side glazed [n -S]
JACONETS	JACONET, (Hindi) a kind of thin cotton fabric, esp. with one side glazed [n]
JAGGARIES	JAGGARY, (Hindi) a coarse, dark sugar, also JAGGERY, JAGGHERY, JAGRA [n]
JAGGARY	(Hindi) a coarse, dark sugar, also JAGGERY, JAGGHERY, JAGRA [n JAGGARIES]
JAGGERIES	JAGGERY, (Hindi) a coarse, dark sugar, also JAGGARY, JAGGHERY, JAGRA [n]
JAGGERY	(Hindi) a coarse, dark sugar, also JAGGARY, JAGGHERY, JAGRA [n JAGGERIES]
JAGGHERIES	JAGGHERY, (Hindi) a coarse, dark sugar, also JAGGARY, JAGGERY, JAGRA [n]
JAGGHERY	(Hindi) a coarse, dark sugar, also JAGGARY, JAGGERY, JAGRA [n JAGGHERIES]
JAGHIR	(Hindi) the government revenues of a tract of land assigned with power to administer, also JAGHIRE, JAGIR [n -S]
JAGHIRDAR	(Hindi) the holder of a jaghir, in Pakistan, a village or district the government and revenues of which are assigned to some person [n -S]
JAGHIRDARS	JAGHIRDAR, (Hindi) the holder of a jaghir, in Pakistan, a village or district the government and revenues of which are assigned to some person [n]
JAGHIRE	(Hindi) the government revenues of a tract of land assigned with power to administer, also JAGHIR, JAGIR [n -S]
JAGHIRES	JAGHIRE, (Hindi) the government revenues of a tract of land assigned with power to administer, also JAGHIR, JAGIR [n]
JAGHIRS	JAGHIR, (Hindi) the government revenues of a tract of land assigned with power to administer, also JAGHIRE, JAGIR [n]
JAGIR	(Hindi) the government revenues of a tract of land assigned with power to administer, also JAGHIR, JAGHIRE [n -S]
JAGIRS	JAGIR, (Hindi) the government revenues of a tract of land assigned with power to administer, also JAGHIR, JAGHIRE [n]
JAGRA	(Hindi) a coarse, dark sugar, also JAGGARY, JAGGERY, JAGGHERY [n -S]
JAGRAS	JAGRA, (Hindi) a coarse, dark sugar, also JAGGARY, JAGGERY, JAGGHERY [n]
JAI	(Hindi) onward to victory [interj]
JAK	an East Indian tree of the breadfruit family, also JACKFRUIT, JAKFRUIT [n -S]
JAKFRUIT	an East Indian tree of the breadfruit family, also JACKFRUIT, JAK [n -S]
JAKFRUITS	JAKFRUIT, an East Indian tree of the breadfruit family, also JACKFRUIT, JAK [n]
JAKS	JAK, an East Indian tree of the breadfruit family, also JACKFRUIT, JAKFRUIT [n]
JALEBI	(Hindi) an Asian snack of deep-fried dough covered with syrup, also JALLEBI, JILEBI [n -S]
JALEBIS	JALEBI, (Hindi) an Asian snack of deep-fried dough covered with syrup, also JALLEBI, JILEBI [n]
JALFREZI	a hot-flavoured Indian dish of meat or vegetables stir-fried with green chillis and spices [n -S]
JALFREZIS	JALFREZI, a hot-flavoured Indian dish of meat or vegetables stir-fried with green chillis and spices [n]
JALLEBI	(Hindi) an Asian snack of deep-fried dough covered with syrup, also JALEBI, JILEBI [n -S]
JALLEBIS	JALLEBI, (Hindi) an Asian snack of deep-fried dough covered with syrup, also JALEBI, JILEBI [n]
JAMADAR	(Urdu) in the native army of India, an officer of a rank corresponding to that of lieutenant in the English army, also JEMADAR, JEMIDAR [n -S]
JAMADARS	JAMADAR, (Urdu) in the native army of India, an officer of a rank corresponding to that of lieutenant in the English army, also JEMADAR, JEMIDAR [n]
JAMBOLAN	(Sanskrit) the rose-apple tree of Malaysia, also JAMBOLANA, JAMBOOL, JAMBU, JAMBUL [n -S]
JAMBOLANA	(Sanskrit) the rose-apple tree of Malaysia, also JAMBOLAN, JAMBOOL, JAMBU, JAMBUL [n -S]
JAMBOLANAS	JAMBOLANA, (Sanskrit) the rose-apple tree of Malaysia, also JAMBOLAN, JAMBOOL, JAMBU, JAMBUL [n]
JAMBOLANS	JAMBOLAN, (Sanskrit) the rose-apple tree of Malaysia, also JAMBOLANA, JAMBOOL, JAMBU, JAMBUL [n]
JAMBOOL	(Sanskrit) the rose-apple tree, also JAMBU, JAMBOLAN, JAMBUL [n -S]
JAMBOOLS	JAMBOOL, (Sanskrit) the rose-apple tree, also JAMBU, JAMBOLAN, JAMBUL [n]
JAMBU	(Sanskrit) the rose-apple tree of Malaysia, also JAMBOLAN, JAMBOLANA, JAMBOOL, JAMBUL [n -S]
JAMBUL	(Sanskrit) the rose-apple tree of Malaysia, also JAMBOLAN, JAMBOLANA, JAMBOOL, JAMBU [n -S]
JAMBULS	JAMBUL, (Sanskrit) the rose-apple tree of Malaysia, also JAMBOLAN, JAMBOLANA, JAMBOOL, JAMBU [n]
JAMBUS	JAMBU, (Sanskrit) the rose-apple tree of Malaysia, also JAMBOLAN, JAMBOLANA, JAMBOOL, JAMBUL [n]
JAMDANI	(Urdu) a kind of Dacca muslin [n -S]
JAMDANIS	JAMDANI, (Urdu) a kind of Dacca muslin [n]
JAMPAN	(Bengali) an Indian sedan chair [n -S]
JAMPANEE	(Bengali) an Indian sedan chair bearer, also JAMPANI [n -S]
JAMPANEES	JAMPANEE, (Bengali) an Indian sedan chair bearer, also JAMPANI [n]
JAMPANI	(Bengali) an Indian sedan chair bearer, also JAMPANEE [n -S]
JAMPANIS	JAMPANI, (Bengali) an Indian sedan chair bearer, also JAMPANEE [n]
JAMPANS	JAMPAN, (Bengali) an Indian sedan chair [n]
JANATA	(Hindi) the general public [n -S]
JANATAS	JANATA, (Hindi) the general public [n]
JAROOL	(Bengali) a deciduous tree of the purple loosestrife family, also JARUL [n -S]
JAROOLS	JAROOL, (Bengali) a deciduous tree of the purple loosestrife family, also JARUL [n]
JARUL	(Bengali) a deciduous tree of the purple loosestrife family, also JAROOL [n -S]
JARULS	JARUL, (Bengali) a deciduous tree of the purple loosestrife family, also JAROOL [n]
JAWAN	(Urdu) an Indian common soldier [n -S]
JAWANS	JAWAN, (Urdu) an Indian common soldier [n]
JAWARI	(Hindi) Indian millet, aka durra, also JOWAR, JOWARI [n -S]
JAWARIS	JAWARI, (Hindi) Indian millet, aka durra, also JOWAR, JOWARI [n]
JEMADAR	(Urdu) in the native army of India, an officer of a rank corresponding to that of lieutenant in the English army, also JAMADAR, JEMIDAR [n -S]
JEMADARS	JEMADAR, (Urdu) in the native army of India, an officer of a rank corresponding to that of lieutenant in the English army, also JAMADAR, JEMIDAR [n]
JEMIDAR	(Urdu) in the native army of India, an officer of a rank corresponding to that of lieutenant in the English army, also JAMADAR, JEMADAR [n -S]
JEMIDARS	JEMIDAR, (Urdu) in the native army of India, an officer of a rank corresponding to that of lieutenant in the English army, also JAMADAR, JEMADAR [n]
JEQUERITIES	JEQUERITY, the tropical shrub Indian liquorice, also JEQUIRITY [n]
JEQUERITY	the tropical shrub Indian liquorice, also JEQUIRITY [n JEQUERITIES]
JEQUIRITIES	JEQUIRITY, the tropical shrub Indian liquorice, also JEQUERITY [n]
JEQUIRITY	the tropical shrub Indian liquorice, also JEQUERITY [n JEQUIRITIES]
JHALA	(Sanskrit) in Hindu music, part of the second movement of a raga [n -S]
JHALAS	JHALA, (Sanskrit) in Hindu music, part of the second movement of a raga [n]
JHATKA	(Punjabi) the slaughter of animals for food in accordance with Sikh law [n -S]
JHATKAS	JHATKA, (Punjabi) the slaughter of animals for food in accordance with Sikh law [n]
JILEBI	(Hindi) an Asian snack of deep-fried dough covered with syrup, also JALEBI, JALLEBI [n -S]
JILEBIS	JILEBI, (Hindi) an Asian snack of deep-fried dough covered with syrup, also JALEBI, JALLEBI [n]
JINGAL	(Hindi) a large Chinese or Indian swivel-musket, also GINGAL, GINGALL, JINGALL [n -S]
JINGALL	(Hindi) a large Chinese or Indian swivel-musket, also GINGAL, GINGALL, JINGAL [n -S]
JINGALLS	JINGALL, (Hindi) a large Chinese or Indian swivel-musket, also GINGAL, GINGALL, JINGAL [n]
JINGALS	JINGAL, (Hindi) a large Chinese or Indian swivel-musket, also GINGAL, GINGALL, JINGALL [n]
JINJILI	(Hindi) the sesame seed or its oil, also GINGELEY, GINGELI, GINGELLI, GINGELLY, GINGELY, GINGILI, GINGILLI [n -S]
JINJILIS	JINJILI, (Hindi) the sesame seed or its oil, also GINGELEY, GINGELI, GINGELLI, GINGELLY, GINGELY, GINGILI, GINGILLI [n]
JNANA	(Sanskrit) knowledge acquired through meditation [n -S]
JNANAS	JNANA, (Sanskrit) knowledge acquired through meditation [n]
JODHPUR	(Hindi) usually in plural, long riding-breeches, wide around the hips but close-fitting from knee to ankle [n -S]
JODHPURS	JODHPUR, (Hindi) usually in plural, long riding-breeches, wide around the hips but close-fitting from knee to ankle [n]
JOHNNYCAKE	a kind of bread made of the meal of maize (Indian corn), mixed with water or milk, etc. and baked, also JONNYCAKE [n -S]
JOHNNYCAKES	JOHNNYCAKE, a kind of bread made of the meal of maize (Indian corn), mixed with water or milk, etc. and baked, also JONNYCAKE [n]
JONNYCAKE	a kind of bread made of the meal of maize (Indian corn), mixed with water or milk, etc., and baked, also JOHNNYCAKE [n -S]
JONNYCAKES	JONNYCAKE, a kind of bread made of the meal of maize (Indian corn), mixed with water or milk, etc., and baked, also JOHNNYCAKE [n]
JOR	in Indian music, the second movement of a raga [n -S]
JORS	JOR, in Indian music, the second movement of a raga [n]
JOWAR	(Hindi) Indian millet, aka durra, also JAWARI, JOWARI [n -S]
JOWARI	(Hindi) Indian millet, aka durra, also JAWARI, JOWAR [n -S]
JOWARIS	JOWARI, (Hindi) Indian millet, aka durra, also JAWARI, JOWAR [n]
JOWARS	JOWAR, (Hindi) Indian millet, aka durra, also JAWARI, JOWARI [n]
JUGAAD	(Hindi) a resourceful approach to problem-solving [n -S]
JUGAADS	JUGAAD, (Hindi) a resourceful approach to problem-solving [n]
JUGGERNAUT	(Sanskrit) a massive relentless force, person, institution, etc. that crushes everything in its path [n -S]
JUGGERNAUTS	JUGGERNAUT, (Sanskrit) a massive relentless force, person, institution, etc. that crushes everything in its path [n]
KAAMCHOR	(Hindi) a shirker, also KAMCHOR [n -S]
KAAMCHORS	KAAMCHOR, (Hindi) a shirker, also KAMCHOR [n]
KABADDI	(Tamil) an Asian version of tag played between two teams of nine boys or young men [n -S]
KABADDIS	KABADDI, (Tamil) an Asian version of tag played between two teams of nine boys or young men [n]
KABIKI	a fruit tree native to India, the fruit of which is edible and often used in preserves, and the fragrant flowers of which are used in cosmetics [n -S]
KABIKIS	KABIKI, a fruit tree native to India, the fruit of which is edible and often used in preserves, and the fragrant flowers of which are used in cosmetics [n]
KACCHA	(Punjabi) short trousers worn by Sikhs, also KUCCHA [n -S]
KACCHAS	KACCHA, (Punjabi) short trousers worn by Sikhs, also KUCCHA [n]
KACHA	(Hindi) made of dried mud, makeshift, also CUTCHA, KACHCHA, KUCHCHA, KUTCHA [adj]
KACHAHARI	(Hindi) an Indian magistrate's office or courthouse, also CUTCHERRY, CUTCHERY, KACHAHRI, KACHERI [n -S]
KACHAHARIS	KACHAHARI, (Hindi) an Indian magistrate's office or courthouse, also CUTCHERRY, CUTCHERY, KACHAHRI, KACHERI [n]
KACHAHRI	(Hindi) an Indian magistrate's office or courthouse, also CUTCHERRY, CUTCHERY, KACHAHARI, KACHERI [n -S]
KACHAHRIS	KACHAHRI, (Hindi) an Indian magistrate's office or courthouse, also CUTCHERRY, CUTCHERY, KACHAHARI, KACHERI [n]
KACHCHA	(Hindi) made of dried mud, makeshift, also CUTCHA, KACHA, KUCHCHA, KUTCHA [adj]
KACHERI	(Hindi) an Indian magistrate's office or courthouse, also CUTCHERRY, CUTCHERY, KACHAHARI, KACHAHRI [n -S]
KACHERIS	KACHERI, (Hindi) an Indian magistrate's office or courthouse, also CUTCHERRY, CUTCHERY, KACHAHARI, KACHAHRI [n]
KACHORI	(Hindi) an Indian snack of pastry with a spicy filling, also KATCHURI [n -S]
KACHORIS	KACHORI, (Hindi) an Indian snack of pastry with a spicy filling, also KATCHURI [n]
KACHUMBER	(Hindi) a salad of chopped onion, tomato, cucumber, and (sometimes) other vegetables [n -S]
KACHUMBERS	KACHUMBER, (Hindi) a salad of chopped onion, tomato, cucumber, and (sometimes) other vegetables [n]
KADAI	(Hindi) a wok-like copper utensil used in Asian cookery; a dish prepared in this, also KARAHI [n -S]
KADAIS	KADAI, (Hindi) a wok-like copper utensil used in Asian cookery; a dish prepared in this, also KARAHI [n]
KAJAWAH	(Urdu) a camel saddle [n -S]
KAJAWAHS	KAJAWAH, (Urdu) a camel saddle [n]
KALONJI	(Hindi) the seeds of a South Asian plant used as a spice [n -S]
KALONJIS	KALONJI, (Hindi) the seeds of a South Asian plant used as a spice [n]
KALPA	(Sanskrit) one of the Brahmanic eons, a period of 4,320,000,000 years, also CALPA [n -S]
KALPAS	KALPA, (Sanskrit) one of the Brahmanic eons, a period of 4,320,000,000 years, also CALPA [n]
KAMA	(Sanskrit) in Indian philosophy, earthly desire [n -S]
KAMALA	(Hindi) the red dusty hairs of the capsules of an East Indian tree used for dyeing silk, also KAMELA, KAMILA [n -S]
KAMALAS	KAMALA, (Hindi) the red dusty hairs of the capsules of an East Indian tree used for dyeing silk, also KAMELA, KAMILA [n]
KAMAS	KAMA, (Sanskrit) in Indian philosophy, earthly desire [n]
KAMCHOR	(Hindi) a shirker, also KAAMCHOR [n -S]
KAMCHORS	KAMCHOR, (Hindi) a shirker, also KAAMCHOR [n]
KAMEES	(Urdu) in South Asia, a loose tunic, worn by women, also KAMEEZ, QAMEEZ [n -ES]
KAMEESES	KAMEES, (Urdu) in South Asia, a loose tunic, worn by women, also KAMEEZ, QAMEEZ [n]
KAMEEZ	(Urdu) in South Asia, a loose tunic, worn by women, also KAMEES, QAMEEZ [n -ES]
KAMEEZES	KAMEEZ, (Urdu) in South Asia, a loose tunic, worn by women, also KAMEES, QAMEEZ [n]
KAMELA	(Hindi) the red dusty hairs of the capsules of an East Indian tree used for dyeing silk, also KAMALA, KAMILA [n -S]
KAMELAS	KAMELA, (Hindi) the red dusty hairs of the capsules of an East Indian tree used for dyeing silk, also KAMALA, KAMILA [n]
KAMILA	(Hindi) the red dusty hairs of the capsules of an East Indian tree used for dyeing silk, also KAMALA, KAMELA [n -S]
KAMILAS	KAMILA, (Hindi) the red dusty hairs of the capsules of an East Indian tree used for dyeing silk, also KAMALA, KAMELA [n]
KANDIES	KANDY, (Tamil) a South Indian weight, approximately 500 lb. Imperial, also CANDIE [n]
KANDY	(Tamil) a South Indian weight, approximately 500 lb. Imperial, also CANDIE [n KANDIES]
KANGHA	(Punjabi) a coloured cotton cloth worn as a dress, also KANGA, KHANGA [n -S]
KANGHAS	KANGHA, (Punjabi) a coloured cotton cloth worn as a dress, also KANGA, KHANGA [n]
KANJOOS	(Hindi) a stingy person, also KANJUS, KUNJOOS [n -ES]
KANJOOSES	KANJOOS, (Hindi) a stingy person, also KANJUS, KUNJOOS [n]
KANJUS	(Hindi) a stingy person, also KANJOOS, KUNJOOS [n -ES]
KANJUSES	KANJUS, (Hindi) a stingy person, also KANJOOS, KUNJOOS [n]
KANKAR	(Hindi) a limestone found in India, also KUNKAR, KUNKUR [n -S]
KANKARS	KANKAR, (Hindi) a limestone found in India, also KUNKAR, KUNKUR [n]
KANS	(Hindi) a type of Indian grass [n -ES]
KANSES	KANS, (Hindi) a type of Indian grass [n]
KANTHA	(Bengali) an embroidered cloth quilt [n -S]
KANTHAS	KANTHA, (Bengali) an embroidered cloth quilt [n]
KARA	(Punjabi) a steel bangle, worn by Sikhs [n -S]
KARAHI	(Hindi) a wok-like copper utensil used in Asian cookery; a dish prepared in this, also KADAI [n -S]
KARAHIS	KARAHI, (Hindi) a wok-like copper utensil used in Asian cookery; a dish prepared in this, also KADAI [n]
KARAIT	(Hindi) a venomous snake of India, also KRAIT [n -S]
KARAITS	KARAIT, (Hindi) a venomous snake of India, also KRAIT [n]
KARAS	KARA, (Punjabi) a steel bangle, worn by Sikhs [n]
KARMA	(Sanskrit) the moral quality of actions regarded as determining the nature of a future existence [n -S]
KARMAS	KARMA, (Sanskrit) the moral quality of actions regarded as determining the nature of a future existence [n]
KARMIC	(Sanskrit) relating to karma, the moral quality of actions regarded as determining the nature of a future existence [adj KARMICALLY]
KARMICALLY	KARMIC, (Sanskrit) relating to karma, the moral quality of actions regarded as determining the nature of a future existence [adv]
KASME	(Hinglish) I swear [interj]
KATCHURI	(Hindi) an Indian snack of pastry with a spicy filling, also KACHORI [n -S]
KATCHURIS	KATCHURI, (Hindi) an Indian snack of pastry with a spicy filling, also KACHORI [n]
KATHAK	(Sanskrit) a classical dance of India in which brief passages of mime alternate with rapid, rhythmic dance [n -S]
KATHAKALI	(Malayalam) a highly stylized form of South Indian drama, using dance and mime [n -S]
KATHAKALIS	KATHAKALI, (Malayalam) a highly stylized form of South Indian drama, using dance and mime [n]
KATHAKS	KATHAK, (Sanskrit) a classical dance of India in which brief passages of mime alternate with rapid, rhythmic dance [n]
KEDDAH	(Hindi) an enclosure for elephants, also KHEDA, KHEDAH [n -S]
KEDDAHS	KEDDAH, (Hindi) an enclosure for elephants, also KHEDA, KHEDAH [n]
KEDGEREE	(Hindi) a food in India [n -S]
KEDGEREES	KEDGEREE, (Hindi) a food in India [n]
KEEMA	(Hindi) in Indian cookery, minced beef, also KHEEMA, QEEMA [n -S]
KEEMAS	KEEMA, (Hindi) in Indian cookery, minced beef, also KHEEMA, QEEMA [n]
KELLAUT	(Hindi) an Indian robe of honour, also KILLUT, KHALAT, KHILAT [n -S]
KELLAUTS	KELLAUT, (Hindi) an Indian robe of honour, also KILLUT, KHALAT, KHILAT [n]
KESH	(Punjabi) the uncut hair and beard of a male Sikh [n -ES]
KESHES	KESH, (Punjabi) the uncut hair and beard of a male Sikh [n]
KHADDAR	(Hindi) a homespun cotton cloth, also KHADI [n -S]
KHADDARS	KHADDAR, (Hindi) a homespun cotton cloth, also KHADI [n]
KHADI	(Hindi) a homespun cotton cloth, also KHADDAR [n -S]
KHADIS	KHADI, (Hindi) a homespun cotton cloth, also KHADDAR [n]
KHAKI	(Urdu) a dull brownish colour [n -S]
KHAKIS	KHAKI, (Urdu) a dull brownish colour [n]
KHALAT	(Hindi) an Indian robe of honour, also KILLUT, KELLAUT, KHILAT [n -S]
KHALATS	KHALAT, (Hindi) an Indian robe of honour, also KILLUT, KELLAUT, KHILAT [n]
KHANDA	(Punjabi) a double-edged Sikh sword [n -S]
KHANDAS	KHANDA, (Punjabi) a double-edged Sikh sword [n]
KHANSAMA	(Hindi) a house-steward or butler in India, also KHANSAMAH [n -S]
KHANSAMAH	(Hindi) a house-steward or butler in India, also KHANSAMA [n -S]
KHANSAMAHS	KHANSAMAH, (Hindi) a house-steward or butler in India, also KHANSAMA [n]
KHANSAMAS	KHANSAMA, (Hindi) a house-steward or butler in India, also KHANSAMAH [n]
KHARIF	(Urdu) in India, a crop sown before the monsoon to ripen in autumn [n -S]
KHARIFS	KHARIF, (Urdu) in India, a crop sown before the monsoon to ripen in autumn [n]
KHAYAL	(Urdu) a kind of classical Indian vocal music, also KHYAL [n -S]
KHAYALS	KHAYAL, (Urdu) a kind of classical Indian vocal music, also KHYAL [n]
KHEDA	(Hindi) an enclosure for elephants, also KEDDAH, KHEDAH [n -S]
KHEDAH	(Hindi) an enclosure for elephants, also KEDDAH, KHEDA [n -S]
KHEDAHS	KHEDAH, (Hindi) an enclosure for elephants, also KEDDAH, KHEDA [n]
KHEDAS	KHEDA, (Hindi) an enclosure for elephants, also KEDDAH, KHEDAH [n]
KHEEMA	(Hindi) in Indian cookery, minced beef, also KEEMA, QEEMA [n -S]
KHEEMAS	KHEEMA, (Hindi) in Indian cookery, minced beef, also KEEMA, QEEMA [n]
KHIDMATGAR	(Urdu) a male waiter, also KHIDMUTGAR, KHITMATGAR, KHITMUTGAR [n -S]
KHIDMATGARS	KHIDMATGAR, (Urdu) a male waiter, also KHIDMUTGAR, KHITMATGAR, KHITMUTGAR [n]
KHIDMUTGAR	(Urdu) a male waiter, also KHIDMATGAR, KHITMATGAR, KHITMUTGAR [n -S]
KHIDMUTGARS	KHIDMUTGAR, (Urdu) a male waiter, also KHIDMATGAR, KHITMATGAR, KHITMUTGAR [n]
KHILAT	(Hindi) a robe of honour, also KELLAUT, KHALAT, KILLUT [n -S]
KHILATS	KHILAT, (Hindi) a robe of honour, also KELLAUT, KHALAT, KILLUT [n]
KHITMATGAR	(Urdu) a male waiter, also KHIDMATGAR, KHIDMUTGAR, KHITMUTGAR [n -S]
KHITMATGARS	KHITMATGAR, (Urdu) a male waiter, also KHIDMATGAR, KHIDMUTGAR, KHITMUTGAR [n]
KHITMUTGAR	(Urdu) a male waiter, also KHIDMATGAR, KHIDMUTGAR, KHITMATGAR [n -S]
KHITMUTGARS	KHITMUTGAR, (Urdu) a male waiter, also KHIDMATGAR, KHIDMUTGAR, KHITMATGAR [n]
KHUD	(Hindi) in India, a pit, hollow, ravine [n -S]
KHUDS	KHUD, (Hindi) in India, a pit, hollow, ravine [n]
KHUKURI	(Hindi) a sharp, curved Gurkha knife, also KUKRI, KUKURI [n -S]
KHUKURIS	KHUKURI, (Hindi) a sharp, curved Gurkha knife, also KUKRI, KUKURI [n]
KHURTA	(Hindi) a loose-fitting tunic of India, also KURTA [n -S]
KHURTAS	KHURTA, (Hindi) a loose-fitting tunic of India, also KURTA [n]
KHYAL	(Urdu) a kind of classical Indian vocal music, also KHAYAL [n -S]
KHYALS	KHYAL, (Urdu) a kind of classical Indian vocal music, also KHAYAL [n]
KILLADAR	(Hindi) in India, the commandant of a fort or garrison [n -S]
KILLADARS	KILLADAR, (Hindi) in India, the commandant of a fort or garrison [n]
KILLUT	(Hindi) an Indian robe of honour, also KELLAUT, KHALAT, KHILAT [n -S]
KILLUTS	KILLUT, (Hindi) an Indian robe of honour, also KELLAUT, KHALAT, KHILAT [n]
KINCOB	(Urdu) a rich silk fabric made in India [n -S]
KINCOBS	KINCOB, (Urdu) a rich silk fabric made in India [n]
KIRANA	(in India) a small, usually family-owned shop selling groceries and other sundries [n -S]
KIRANAS	KIRANA, (in India) a small, usually family-owned shop selling groceries and other sundries [n]
KIRPAN	(Punjabi) a small sword of religious significance to Sikhs [n -S]
KIRPANS	KIRPAN, (Punjabi) a small sword of religious significance to Sikhs [n]
KIRTAN	(Sanskrit) devotional singing, usually accompanied by musical instruments [n -S]
KIRTANS	KIRTAN, (Sanskrit) devotional singing, usually accompanied by musical instruments [n]
KISAN	(Hindi) an Indian peasant or farm worker [n -S]
KISANS	KISAN, (Hindi) an Indian peasant or farm worker [n]
KITTUL	(Sinhalese) the jaggery palm; a fibre obtained from the leafstalks of this, used for making ropes, brushes, etc., also KITUL [n -S]
KITTULS	KITTUL, (Sinhalese) the jaggery palm; a fibre obtained from the leafstalks of this, used for making ropes, brushes, etc., also KITUL [n]
KITUL	(Sinhalese) the jaggery palm; a fibre obtained from the leafstalks of this, used for making ropes, brushes, etc., also KITTUL [n -S]
KITULS	KITUL, (Sinhalese) the jaggery palm; a fibre obtained from the leafstalks of this, used for making ropes, brushes, etc., also KITTUL [n]
KOEL	(Hindi) an Asian or Australian bird of the cuckoo family [n -S]
KOELS	KOEL, (Hindi) an Asian or Australian bird of the cuckoo family [n]
KOFTA	(Hindi) in India, fried balls of meat or vegetables [n -S]
KOFTAS	KOFTA, (Hindi) in India, fried balls of meat or vegetables [n]
KOFTGAR	(Urdu) a craftsman in koftgari, who inlays steel with gold [n -S]
KOFTGARI	(Urdu) the craft of inlaying steel with gold [n -S]
KOFTGARIS	KOFTGARI, (Urdu) the craft of inlaying steel with gold [n]
KOFTGARS	KOFTGAR, (Urdu) a craftsman in koftgari, who inlays steel with gold [n]
KOKAM	(Marathi) an East Indian tree, also KOKUM, KOOKUM [n -S]
KOKAMS	KOKAM, (Marathi) an East Indian tree, also KOKUM, KOOKUM [n]
KOKUM	(Marathi) an East Indian tree, also KOKAM, KOOKUM [n -S]
KOKUMS	KOKUM, (Marathi) an East Indian tree, also KOKAM, KOOKUM [n]
KOOKUM	(Marathi) an East Indian tree, also KOKAM, KOKUM [n -S]
KOOKUMS	KOOKUM, (Marathi) an East Indian tree, also KOKAM, KOKUM [n]
KORMA	(Hindi) a mild curry, also QORMA [n -S]
KORMAS	KORMA, (Hindi) a mild curry, also QORMA [n]
KOS	a measure of distance in India, also COSS, KOSS [n KOSES or KOSSES]
KOSES	KOS, a measure of distance in India, also COSS, KOSS [n]
KOSS	(Hindi) a measure of distance in India, also COSS, KOS [n -ES]
KOSSES	KOS, a measure of distance in India, also COSS, KOSS [n]
KOTWAL	(Hindi) the chief constable of an Indian town, also COTWAL [n -S]
KOTWALS	KOTWAL, (Hindi) the chief constable of an Indian town, also COTWAL [n]
KRAIT	(Hindi) a venomous snake of India, also KARAIT [n -S]
KRAITS	KRAIT, (Hindi) a venomous snake of India, also KARAIT [n]
KRISHI	(Hindi) agriculture [n -S]
KRISHIS	KRISHI, (Hindi) agriculture [n]
KUCHCHA	(Hindi) made of dried mud, makeshift, also CUTCHA, KACHA, KACHCHA, KUTCHA [adj]
KUKRI	(Hindi) a sharp, curved Gurkha knife, also KHUKURI, KUKURI [n -S]
KUKRIS	KUKRI, (Hindi) a sharp, curved Gurkha knife, also KHUKURI, KUKURI [n]
KUKURI	(Hindi) a sharp, curved Gurkha knife, also KHUKURI, KUKRI [n -S]
KUKURIS	KUKURI, (Hindi) a sharp, curved Gurkha knife, also KHUKURI, KUKRI [n]
KULFI	(Hindi) an Indian dessert made by freezing milk which has been concentrated by boiling away some of the water in it, and flavoured with nuts and cardamom seeds [n -S]
KULFIS	KULFI, (Hindi) an Indian dessert made by freezing milk which has been concentrated by boiling away some of the water in it, and flavoured with nuts and cardamom seeds [n]
KUMARI	(Hindi) in India, the title of Miss [n -S]
KUMARIS	KUMARI, (Hindi) in India, the title of Miss [n]
KUMKUM	(Hindi) a red powder used by Hindu women as a cosmetic [n -S]
KUMKUMS	KUMKUM, (Hindi) a red powder used by Hindu women as a cosmetic [n]
KUMMERBUND	(Hindi) a waistband, a sash, also CUMBERBUND, CUMMERBUND [n -S]
KUMMERBUNDS	KUMMERBUND, (Hindi) a waistband, a sash, also CUMBERBUND, CUMMERBUND [n]
KUNDALINI	(Sanskrit) in yoga, spiritual energy that lies dormant at base of spine until the brain is enlightened [n -S]
KUNDALINIS	KUNDALINI, (Sanskrit) in yoga, spiritual energy that lies dormant at base of spine until the brain is enlightened [n]
KUNJOOS	(Hindi) a stingy person, also KANJOOS, KANJUS [n -ES]
KUNJOOSES	KUNJOOS, (Hindi) a stingy person, also KANJOOS, KANJUS [n]
KUNKAR	(Hindi) a limestone found in India, also KANKAR, KUNKUR [n -S]
KUNKARS	KUNKAR, (Hindi) a limestone found in India, also KANKAR, KUNKUR [n]
KUNKUR	(Hindi) a limestone found in India, also KANKAR, KUNKAR [n -S]
KUNKURS	KUNKUR, (Hindi) a limestone found in India, also KANKAR, KUNKAR [n]
KURTA	(Hindi) a loose-fitting tunic of India, also KHURTA [n -S]
KURTAS	KURTA, (Hindi) a loose-fitting tunic of India, also KHURTA [n]
KUTA	(Hinglish) a male dog; a man or a boy regarded as unpleasant or contemptible [n -S]
KUTAS	KUTA, (Hinglish) a male dog; a man or a boy regarded as unpleasant or contemptible [n]
KUTCHA	(Hindi) made of dried mud, makeshift, also KACHA, KACHCHA, KUCHCHA [adj]
KUTI	(Hinglish) a female dog; a woman or girl regarded as unpleasant or contemptible [n -S]
KUTIS	KUTI, (Hinglish) a female dog; a woman or girl regarded as unpleasant or contemptible [n]
LAKH	(Hindi) a unit of counting, one hundred thousand [n -S]
LAKHS	LAKH, (Hindi) a unit of counting, one hundred thousand [n]
LANGAR	(Punjabi) a dining hall in a Sikh place of worship [n -S]
LANGARS	LANGAR, (Punjabi) a dining hall in a Sikh place of worship [n]
LANGUR	(Hindi) a long-tailed Asian monkey [n -S]
LANGURS	LANGUR, (Hindi) a long-tailed Asian monkey [n]
LASCAR	(Hindi) an East Indian sailor, also LASHKAR [n -S]
LASCARS	LASCAR, (Hindi) an East Indian sailor, also LASHKAR [n]
LASHKAR	(Hindi) an East Indian sailor, also LASCAR [n -S]
LASHKARS	LASHKAR, (Hindi) an East Indian sailor, also LASCAR [n]
LASSI	(Hindi) a drink based on sour milk, popular in the East [n -S]
LASSIS	LASSI, (Hindi) a drink based on sour milk, popular in the East [n]
LATHEE	(Hindi) in India, a heavy stick used as a weapon, also LATHI [n -S]
LATHEES	LATHEE, (Hindi) in India, a heavy stick used as a weapon, also LATHI [n]
LATHI	(Hindi) in India, a heavy stick used as a weapon, also LATHEE [n -S]
LATHIS	LATHI, (Hindi) in India, a heavy stick used as a weapon, also LATHEE [n]
LEEP	(Hindi) to plaster with cow-dung; to boil or scald [v -ED, -ING, -S]
LEEPED	LEEP, (Hindi) to plaster with cow-dung; to boil or scald [v]
LEEPING	LEEP, (Hindi) to plaster with cow-dung; to boil or scald [v]
LEEPS	LEEP, (Hindi) to plaster with cow-dung; to boil or scald [v]
LINGA	(Sanskrit) the phallic symbol under which Siva is principally worshipped in his character of the creative and reproductive power, also LINGAM [n -S]
LINGAM	(Sanskrit) the phallic symbol under which Siva is principally worshipped in his character of the creative and reproductive power, also LINGA [n -S]
LINGAMS	LINGAM, (Sanskrit) the phallic symbol under which Siva is principally worshipped in his character of the creative and reproductive power, also LINGA [n]
LINGAS	LINGA, (Sanskrit) the phallic symbol under which Siva is principally worshipped in his character of the creative and reproductive power, also LINGAM [n]
LOHAN	(Sanskrit) a Buddhist who has attained nirvana, aka arhat [n -S]
LOHANS	LOHAN, (Sanskrit) a Buddhist who has attained nirvana, aka arhat [n]
LOTA	(Hindi) a small brass water vessel used in India, also LOTAH [n -S]
LOTAH	(Hindi) a small brass water vessel used in India, also LOTA [n -S]
LOTAHS	LOTAH, (Hindi) a small brass water vessel used in India, also LOTA [n]
LOTAS	LOTA, (Hindi) a small brass water vessel used in India, also LOTAH [n]
LUNGAN	(Chinese) a pulpy fruit related to the litchi, and produced by an evergreen East Indian tree, also LONGAN [n -S]
LUNGANS	LUNGAN, (Chinese) a pulpy fruit related to the litchi, and produced by an evergreen East Indian tree, also LONGAN [n]
LUNGEE	(Hindi) a loincloth worn by men in India, also LUNGI, LUNGYI [n -S]
LUNGEES	LUNGEE, (Hindi) a loincloth worn by men in India, also LUNGI, LUNGYI [n]
LUNGI	(Hindi) in India, a long cloth used as a loin cloth, turban etc., also LUNGEE, LUNGYI [n -S]
LUNGIS	LUNGI, (Hindi) in India, a long cloth used as a loin cloth, turban etc., also LUNGEE, LUNGYI [n]
LUNGYI	(Hindi) in India, a long cloth used as a loin cloth, turban etc., also LUNGEE, LUNGI [n -S]
LUNGYIS	LUNGYI, (Hindi) in India, a long cloth used as a loin cloth, turban etc., also LUNGEE, LUNGI [n]
MACHAN	(Hindi) a raised platform, esp. in a tree, to watch for game [n -S]
MACHANS	MACHAN, (Hindi) a raised platform, esp. in a tree, to watch for game [n]
MACHI	(Hinglish) as in machi chips, fish and chips [adj]
MADRAS	(Tamil) a fine plain-woven cotton or silk [n -ES]
MADRASES	MADRAS, (Tamil) a fine plain-woven cotton or silk [n]
MAHANT	(Hindi) a chief Hindu priest [n -S]
MAHANTS	MAHANT, (Hindi) a chief Hindu priest [n]
MAHARAJA	(Sanskrit) a king or prince in India ranking above a rajah, esp. the sovereign of one of the former native states, also MAHARAJAH [n -S]
MAHARAJAH	(Sanskrit) a king or prince in India ranking above a rajah, esp. the sovereign of one of the former native states, also MAHARAJA [n -S]
MAHARAJAHS	MAHARAJAH, (Sanskrit) a king or prince in India ranking above a rajah, esp. the sovereign of one of the former native states, also MAHARAJA [n]
MAHARAJAS	MAHARAJA, (Sanskrit) a king or prince in India ranking above a rajah, esp. the sovereign of one of the former native states, also MAHARAJAH [n]
MAHARANEE	(Sanskrit) the wife of a maharajah, also MAHARANI [n -S]
MAHARANEES	MAHARANEE, (Sanskrit) the wife of a maharajah, also MAHARANI [n]
MAHARANI	(Sanskrit) the wife of a maharajah, also MAHARANEE [n -S]
MAHARANIS	MAHARANI, (Sanskrit) the wife of a maharajah, also MAHARANEE [n]
MAHARISHI	(Sanskrit) a Hindu teacher of mysticism and spiritual knowledge [n -S]
MAHARISHIS	MAHARISHI, (Sanskrit) a Hindu teacher of mysticism and spiritual knowledge [n]
MAHATMA	(Sanskrit) a religious adept, a sage [n -S]
MAHATMAS	MAHATMA, (Sanskrit) a religious adept, a sage [n]
MAHOUT	(Hindi) the keeper and driver of an elephant [n -S]
MAHOUTS	MAHOUT, (Hindi) the keeper and driver of an elephant [n]
MAHSEER	(Hindi) a large freshwater fish, also MAHSIR [n -S]
MAHSEERS	MAHSEER, (Hindi) a large freshwater fish, also MAHSIR [n]
MAHSIR	(Hindi) a large freshwater fish, also MAHSEER [n -S]
MAHSIRS	MAHSIR, (Hindi) a large freshwater fish, also MAHSEER [n]
MAHUA	(Hindi) a kind of butter-tree with edible flowers, also MAHWA, MOWA, MOWRA [n -S]
MAHUAS	MAHUA, (Hindi) a kind of butter-tree with edible flowers, also MAHWA, MOWA, MOWRA [n]
MAHWA	(Hindi) a kind of butter-tree with edible flowers, also MAHUA, MOWA, MOWRA [n -S]
MAHWAS	MAHWA, (Hindi) a kind of butter-tree with edible flowers, also MAHUA, MOWA, MOWRA [n]
MAIDAN	(Urdu) in India, an open plain; an open space near a town [n -S]
MAIDANS	MAIDAN, (Urdu) in India, an open plain; an open space near a town [n]
MAKHANI	(Hindi) in Indian cookery, a dish cooked in butter or cream, also MAKHNI [n -S]
MAKHANIS	MAKHANI, (Hindi) in Indian cookery, a dish cooked in butter or cream, also MAKHNI [n]
MAKHNI	(Hindi) in Indian cookery, a dish cooked in butter or cream, also MAKHANI [n -S]
MAKHNIS	MAKHNI, (Hindi) in Indian cookery, a dish cooked in butter or cream, also MAKHANI [n]
MALA	(Hindi) a string of beads or knots used in prayer [n -S]
MALAS	MALA, (Hindi) a string of beads or knots used in prayer [n]
MALI	(Hindi) a member of the gardener caste in India [n -S]
MALIK	(Arabic) in India, the head of a village, an employer, also MELIK [n -S]
MALIKS	MALIK, (Arabic) in India, the head of a village, an employer, also MELIK [n]
MALIS	MALI, (Hindi) a member of the gardener caste in India [n]
MAMELUCO	(Portuguese) a child born of a white father and Indian mother, also MAMELUKE, MAMLUK [n -S]
MAMELUCOS	MAMELUCO, (Portuguese) a child born of a white father and Indian mother, also MAMELUKE, MAMLUK [n]
MANDALA	(Sanskrit) a pictorial symbol of the universe in Hindu or Buddhism [n -S]
MANDALAS	MANDALA, (Sanskrit) a pictorial symbol of the universe in Hindu or Buddhism [n]
MANDI	(Hindi) a big market [n -S]
MANDIR	(Hindi) a Hindu temple, also MANDIRA [n -S]
MANDIRA	(Hindi) a Hindu temple, also MANDIR [n -S]
MANDIRAS	MANDIRA, (Hindi) a Hindu temple, also MANDIR [n]
MANDIRS	MANDIR, (Hindi) a Hindu temple, also MANDIRA [n]
MANDIS	MANDI, (Hindi) a big market [n]
MANGALSUTRA	a bead necklace worn by a married Hindu woman whose husband is living [n -S]
MANGALSUTRAS	MANGALSUTRA, a bead necklace worn by a married Hindu woman whose husband is living [n]
MANTRA	(Sanskrit) a sacred word or syllable, also MANTRAM [n -S]
MANTRAM	(Sanskrit) a sacred word or syllable, also MANTRA [n -S]
MANTRAMS	MANTRAM, (Sanskrit) a sacred word or syllable, also MANTRA [n]
MANTRAS	MANTRA, (Sanskrit) a sacred word or syllable, also MANTRAM [n]
MARGOSA	(Portuguese) a large tree of genus Melia found in India, valued for medicinal purposes, aka neem [n -S]
MARGOSAS	MARGOSA, (Portuguese) a large tree of genus Melia found in India, valued for medicinal purposes, aka neem [n]
MARIHUANA	(Spanish) Indian hemp; its dried flowers or leaves smoked as an intoxicant, also MARIJUANA [n -S]
MARIHUANAS	MARIHUANA, (Spanish) Indian hemp; its dried flowers or leaves smoked as an intoxicant, also MARIJUANA [n]
MARIJUANA	(Spanish) Indian hemp; its dried flowers or leaves smoked as an intoxicant, also MARIHUANA [n -S]
MARIJUANAS	MARIJUANA, (Spanish) Indian hemp; its dried flowers or leaves smoked as an intoxicant, also MARIHUANA [n]
MASALA	(Urdu) a mixture of ground spices used in Indian cookery [n -S]
MASALAS	MASALA, (Urdu) a mixture of ground spices used in Indian cookery [n]
MASOOLA	an Indian surfboat, also MASOOLAH, MASSOOLA, MASULA, MASULAH [n -S]
MASOOLAH	an Indian surfboat, also MASOOLA, MASSOOLA, MASULA, MASULAH [n -S]
MASOOLAHS	MASOOLAH, an Indian surfboat, also MASOOLA, MASSOOLA, MASULA, MASULAH [n]
MASOOLAS	MASOOLA, an Indian surfboat, also MASOOLAH, MASSOOLA, MASULA, MASULAH [n]
MASSOOLA	an Indian surfboat, also MASOOLA, MASOOLAH, MASULA, MASULAH [n -S]
MASSOOLAS	MASSOOLA, an Indian surfboat, also MASOOLA, MASOOLAH, MASULA, MASULAH [n]
MASULA	an Indian surfboat, also MASOOLA, MASOOLAH, MASSOOLA, MASULAH [n -S]
MASULAH	an Indian surfboat, also MASOOLA, MASOOLAH, MASSOOLA, MASULA [n -S]
MASULAHS	MASULAH, an Indian surfboat, also MASOOLA, MASOOLAH, MASSOOLA, MASULA [n]
MASULAS	MASULA, an Indian surfboat, also MASOOLA, MASOOLAH, MASSOOLA, MASULAH [n]
MAULVI	(Urdu) a teacher of Islamic law, also MOOLVI, MOOLVIE [n -S]
MAULVIS	MAULVI, (Urdu) a teacher of Islamic law, also MOOLVI, MOOLVIE [n]
MAYA	(Sanskrit) in Buddhist philosophy, the power to produce illusions [n -S]
MAYAS	MAYA, (Sanskrit) in Buddhist philosophy, the power to produce illusions [n]
MAZHBI	(Hindi) a Sikh of low caste [n -S]
MAZHBIS	MAZHBI, (Hindi) a Sikh of low caste [n]
MEHENDI	(Hindi) in India, the practice of painting designs on the hands, feet, etc., using henna, also MEHNDI [n -S]
MEHENDIS	MEHENDI, (Hindi) in India, the practice of painting designs on the hands, feet, etc., using henna, also MEHNDI [n]
MEHNDI	(Hindi) in India, the practice of painting designs on the hands, feet, etc., using henna, also MEHENDI [n -S]
MEHNDIS	MEHNDI, (Hindi) in India, the practice of painting designs on the hands, feet, etc., using henna, also MEHENDI [n]
MELA	(Hindi) in the Indian subcontinent, a Hindu festival or fair [n -S]
MELAS	MELA, (Hindi) in the Indian subcontinent, a Hindu festival or fair [n]
MELIK	(Arabic) in India, the head of a village, an employer, also MALIK [n -S]
MELIKS	MELIK, (Arabic) in India, the head of a village, an employer, also MALIK [n]
MELUNGEON	any of a dark-skinned group of people living in the Appalachians, of mixed White, Indian and Black origin [n -S]
MELUNGEONS	MELUNGEON, any of a dark-skinned group of people living in the Appalachians, of mixed White, Indian and Black origin [n]
MEMSAHIB	(Hindi) a European woman living in colonial India [n -S]
MEMSAHIBS	MEMSAHIB, (Hindi) a European woman living in colonial India [n]
MESTIZA	(Spanish) a (female) person of mixed, esp. Spanish and American-Indian parentage [n -S]
MESTIZAS	MESTIZA, (Spanish) a (female) person of mixed, esp. Spanish and American-Indian parentage [n]
MIRCHI	(Hinglish) hot [adj]
MOFUSSIL	(Urdu) in India, the rural localities of a district as distinguished from the chief station or the town [n -S]
MOFUSSILS	MOFUSSIL, (Urdu) in India, the rural localities of a district as distinguished from the chief station or the town [n]
MOGHUL	(Persian) an important person, also MOGUL, MUGHAL [n -S]
MOGHULS	MOGHUL, (Persian) an important person, also MOGUL, MUGHAL [n]
MOGUL	(Persian) an important person, also MOGHUL, MUGHAL [n -S]
MOGULS	MOGUL, (Persian) an important person, also MOGHUL, MUGHAL [n]
MOHUR	(Persian) a former gold coin of India [n -S]
MOHURS	MOHUR, (Persian) a former gold coin of India [n]
MOKSHA	(Hindu) freedom from the endless cycle of transmigration [n -S]
MOKSHAS	MOKSHA, (Hindu) freedom from the endless cycle of transmigration [n]
MOLA	a brightly-coloured applique or embroidered panel made by Cuna Indian women of Panama [n -S]
MOLAS	MOLA, a brightly-coloured applique or embroidered panel made by Cuna Indian women of Panama [n]
MONAL	(Nepali) a Himalayan pheasant, also MONAUL [n -S]
MONALS	MONAL, (Nepali) a Himalayan pheasant, also MONAUL [n]
MONAUL	(Nepali) a kind of pheasant, native to the Himalayas, also MONAL [n -S]
MONAULS	MONAUL, (Nepali) a kind of pheasant, native to the Himalayas, also MONAL [n]
MONGEESE	MONGOOSE, (Marathi) a carnivorous mammal, also MUNGOOSE [n]
MONGOOSE	(Marathi) a carnivorous mammal, also MUNGOOSE [n MONGOOSES or MONGEESE]
MONGOOSES	MONGOOSE, (Marathi) a carnivorous mammal, also MUNGOOSE [n]
MOOKTAR	(Arabic) an Indian lawyer; a Turkish local government official, also MUKHTAR [n -S]
MOOKTARS	MOOKTAR, (Arabic) an Indian lawyer; a Turkish local government official, also MUKHTAR [n]
MOOLVI	(Urdu) a teacher of Islamic law, also MAULVI, MOOLVIE [n -S]
MOOLVIE	(Urdu) a teacher of Islamic law, also MAULVI, MOOLVI [n -S]
MOOLVIES	MOOLVIE, (Urdu) a teacher of Islamic law, also MAULVI, MOOLVI [n]
MOOLVIS	MOOLVI, (Urdu) a teacher of Islamic law, also MAULVI, MOOLVIE [n]
MOONSHEE	(Hindi) a secretary, interpreter, also MUNSHI [n -S]
MOONSHEES	MOONSHEE, (Hindi) a secretary, interpreter, also MUNSHI [n]
MOORVA	(Sanskrit) a bowstring hemp, also MURVA [n -S]
MOORVAS	MOORVA, (Sanskrit) a bowstring hemp, also MURVA [n]
MORCHA	(Hindi) a hostile demonstration against the government [n -S]
MORCHAS	MORCHA, (Hindi) a hostile demonstration against the government [n]
MOTI	(Hindi) in India, a fat woman or girl [n -S]
MOTIS	MOTI, (Hindi) in India, a fat woman or girl [n]
MOWA	(Hindi) a kind of butter-tree with edible flowers, also MAHUA, MAHWA, MOWRA [n -S]
MOWAS	MOWA, (Hindi) a kind of butter-tree with edible flowers, also MAHUA, MAHWA, MOWRA [n]
MOWRA	(Hindi) a kind of butter-tree with edible flowers, also MAHUA, MAHWA, MOWA [n -S]
MOWRAS	MOWRA, (Hindi) a kind of butter-tree with edible flowers, also MAHUA, MAHWA, MOWA [n]
MRIDAMGAM	(Sanskrit) a two-headed Indian drum, one head being larger than the other, also MRIDANG, MRIDANGA, MRIDANGAM [n -S]
MRIDAMGAMS	MRIDAMGAM, (Sanskrit) a two-headed Indian drum, one head being larger than the other, also MRIDANG, MRIDANGA, MRIDANGAM [n]
MRIDANG	(Sanskrit) a two-headed Indian drum, one head being larger than the other, also MRIDAMGAM, MRIDANGA, MRIDANGAM [n -S]
MRIDANGA	(Sanskrit) a two-headed Indian drum, one head being larger than the other, also MRIDAMGAM, MRIDANG, MRIDANGAM [n -S]
MRIDANGAM	(Sanskrit) a two-headed Indian drum, one head being larger than the other, also MRIDAMGAM, MRIDANG, MRIDANGA [n -S]
MRIDANGAMS	MRIDANGAM, (Sanskrit) a two-headed Indian drum, one head being larger than the other, also MRIDAMGAM, MRIDANG, MRIDANGA [n]
MRIDANGAS	MRIDANGA, (Sanskrit) a two-headed Indian drum, one head being larger than the other, also MRIDAMGAM, MRIDANG, MRIDANGAM [n]
MRIDANGS	MRIDANG, (Sanskrit) a two-headed Indian drum, one head being larger than the other, also MRIDAMGAM, MRIDANGA, MRIDANGAM [n]
MUDRA	(Sanskrit) a hand gesture in East Indian classical dancing [n -S]
MUDRAS	MUDRA, (Sanskrit) a hand gesture in East Indian classical dancing [n]
MUGGAR	(Hindi) a broad-snouted Indian crocodile, also MUGGER, MUGGUR [n -S]
MUGGARS	MUGGAR, (Hindi) a broad-snouted Indian crocodile, also MUGGER, MUGGUR [n]
MUGGER	(Hindi) a broad-snouted Indian crocodile, also MUGGAR, MUGGUR [n -S]
MUGGERS	MUGGER, (Hindi) a broad-snouted Indian crocodile, also MUGGAR, MUGGUR [n]
MUGGUR	(Hindi) a broad-snouted Indian crocodile, also MUGGAR, MUGGER [n -S]
MUGGURS	MUGGUR, (Hindi) a broad-snouted Indian crocodile, also MUGGAR, MUGGER [n]
MUGHALS	MUGHAL, (Persian) an important person, also MOGHUL, MOGUL [n]
MUKHTAR	(Arabic) an Indian lawyer; a Turkish local government official, also MOOKTAR [n -S]
MUKHTARS	MUKHTAR, (Arabic) an Indian lawyer; a Turkish local government official, also MOOKTAR [n]
MULLIGATAWNIES	MULLIGATAWNY, (Tamil) an East Indian curry-soup [n]
MULLIGATAWNY	(Tamil) an East Indian curry-soup [n MULLIGATAWNIES]
MULMUL	(Hindi) a fine, soft muslin, also MULMULL [n -S]
MULMULL	(Hindi) a fine, soft muslin, also MULMUL [n -S]
MULMULLS	MULMULL, (Hindi) a fine, soft muslin, also MULMUL [n]
MULMULS	MULMUL, (Hindi) a fine, soft muslin, also MULMULL [n]
MUNGOOSE	(Marathi) a carnivorous mammal, also MONGOOSE [n -S]
MUNGOOSES	MUNGOOSE, (Marathi) a carnivorous mammal, also MONGOOSE [n]
MUNSHI	(Hindi) a secretary, an interpreter, also MOONSHEE [n -S]
MUNSHIS	MUNSHI, (Hindi) a secretary, an interpreter, also MOONSHEE [n]
MURDABAD	(Urdu) death to, used in slogans [interj]
MURTI	(Sanskrit) an image of a deity which is itself considered divine once consecrated [n -S]
MURTIS	MURTI, (Sanskrit) an image of a deity which is itself considered divine once consecrated [n]
MURVA	(Sanskrit) a bowstring hemp, also MOORVA [n -S]
MURVAS	MURVA, (Sanskrit) a bowstring hemp, also MOORVA [n]
MUSTH	(Hindi) a state of frenzy occurring in male elephants [n -S]
MUSTHS	MUSTH, (Hindi) a state of frenzy occurring in male elephants [n]
MYNA	(Hindi) an Asiatic bird of the starling family, also MYNAH [n -S]
MYNAH	(Hindi) an Asiatic bird of the starling family, also MYNA [n -S]
MYNAHS	MYNAH, (Hindi) an Asiatic bird of the starling family, also MYNA [n]
MYNAS	MYNA, (Hindi) an Asiatic bird of the starling family, also MYNAH [n]
MYROBALAN	the astringent fruit of an Indian tree, aka cherry-plum [n -S]
MYROBALANS	MYROBALAN, the astringent fruit of an Indian tree, aka cherry-plum [n]
NAAN	(Hindi) a kind of slightly leavened Indian bread, also NAN [n -S]
NAANS	NAAN, (Hindi) a kind of slightly leavened Indian bread, also NAN [n]
NABOB	(Urdu) a provincial governor of the Mogul empire in India; a person of great wealth or prominence [n -S]
NABOBERIES	NABOBERY, (Urdu) the state of being a nabob [n]
NABOBERY	(Urdu) the state of being a nabob [n NABOBERIES]
NABOBESS	(Urdu) a female nabob [n -ES]
NABOBESSES	NABOBESS, (Urdu) a female nabob [n]
NABOBISM	(Urdu) great wealth and luxury [n -S]
NABOBISMS	NABOBISM, (Urdu) great wealth and luxury [n]
NABOBS	NABOB, (Urdu) a provincial governor of the Mogul empire in India; a person of great wealth or prominence [n]
NACH	(Hindi) an entertainment in India consisting chiefly of dancing by professional dancing girls, also NAUCH, NAUTCH [n -ES]
NAGA	(Sanskrit) a snake, esp. the cobra; a divine snake in Hindu mythology [n -S]
NAGARI	(Sanskrit) the character in which Sanskrit is usually printed, also DEVANAGARI [n -S]
NAGARIS	NAGARI, (Sanskrit) the character in which Sanskrit is usually printed, also DEVANAGARI [n]
NAGAS	NAGA, (Sanskrit) a snake, esp. the cobra; a divine snake in Hindu mythology [n]
NAIK	(Hindi) the rank of corporal in the Indian army [n -S]
NAIKS	NAIK, (Hindi) the rank of corporal in the Indian army [n]
NAINSOOK	(Hindi) a fine cotton fabric [n -S]
NAINSOOKS	NAINSOOK, (Hindi) a fine cotton fabric [n]
NALA	(Hindi) a ravine, a watercourse, also NALLA, NALLAH, NULLA, NULLAH [n -S]
NALAS	NALA, (Hindi) a ravine, a watercourse, also NALLA, NALLAH, NULLA, NULLAH [n]
NALLA	(Hindi) a ravine, a watercourse, also NALA, NALLAH, NULLA, NULLAH [n -S]
NALLAH	(Hindi) a ravine, a watercourse, also NALA, NALLA, NULLA, NULLAH [n -S]
NALLAHS	NALLAH, (Hindi) a ravine, a watercourse, also NALA, NALLA, NULLA, NULLAH [n]
NALLAS	NALLA, (Hindi) a ravine, a watercourse, also NALA, NALLAH, NULLA, NULLAH [n]
NAMASKAR	(Sanskrit) a traditional Indian salutation, a slight bow with the palms pressed together, also NAMASTE [n -S]
NAMASKARAM	(Sanskrit) a salutation used in India [n -S]
NAMASKARAMS	(Sanskrit) NAMASKARAM, a salutation used in India [n]
NAMASKARS	NAMASKAR, (Sanskrit) a traditional Indian salutation, a slight bow with the palms pressed together, also NAMASTE [n]
NAMASTE	(Sanskrit) a traditional Indian salutation, a slight bow with the palms pressed together, also NAMASKAR [n -S]
NAMASTES	NAMASTE, (Sanskrit) a traditional Indian salutation, a slight bow with the palms pressed together, also NAMASKAR [n]
NAN	(Hindi) a kind of slightly leavened Indian bread, also NAAN [n -S]
NANS	NAN, (Hindi) a kind of slightly leavened Indian bread, also NAAN [n]
NATAK	(Hindi) in India, a drama or play [n -S]
NATAKS	NATAK, (Hindi) in India, a drama or play [n]
NAUCH	(Hindi) an entertainment in India consisting chiefly of dancing by professional dancing girls, also NACH, NAUTCH [n -ES]
NAUCHES	NAUCH, (Hindi) an entertainment in India consisting chiefly of dancing by professional dancing girls, also NACH, NAUTCH [n]
NAUTCH	(Hindi) an entertainment in India consisting chiefly of dancing by professional dancing girls, also NACH, NAUCH [n -ES]
NAUTCHES	NAUTCH, (Hindi) an entertainment in India consisting chiefly of dancing by professional dancing girls, also NACH, NAUCH [n]
NAWAB	(Urdu) a governor of India under the British [n -S]
NAWABS	NAWAB, (Urdu) a governor of India under the British [n]
NAZIR	(Arabic) an Indian court official [n -S]
NAZIRS	NAZIR, (Arabic) an Indian court official [n]
NEEM	(Hindi) an East Indian tree, also NEEMB, NIMB [n -S]
NEEMB	(Hindi) an East Indian tree, also NEEM, NIMB [n -S]
NEEMBS	NEEMB, (Hindi) an East Indian tree, also NEEM, NIMB [n]
NEEMS	NEEM, (Hindi) an East Indian tree, also NEEMB, NIMB [n]
NELUMBIUM	(Tamil) a plant of the Nelumbium genus of waterlilies that includes the sacred lotus, also NELUMBO [n -S]
NELUMBIUMS	NELUMBIUM, (Tamil) a plant of the Nelumbium genus of waterlilies that includes the sacred lotus, also NELUMBO [n]
NELUMBO	(Tamil) a plant of the Nelumbium genus of waterlilies that includes the sacred lotus, also NELUMBIUM [n -S]
NELUMBOS	NELUMBO, (Tamil) a plant of the Nelumbium genus of waterlilies that includes the sacred lotus, also NELUMBIUM [n]
NILGAI	(Hindi) a large antelope, also NILGAU, NILGHAI, NILGHAU, NYLGHAI, NYLGHAU [n -S]
NILGAIS	NILGAI, (Hindi) a large antelope, also NILGAU, NILGHAI, NILGHAU, NYLGHAI, NYLGHAU [n]
NILGAU	(Hindi) a kind of antelope, also NILGAI, NILGHAI, NILGHAU, NYLGHAI, NYLGHAU [n -S]
NILGAUS	NILGAU, (Hindi) a kind of antelope, also NILGAI, NILGHAI, NILGHAU, NYLGHAI, NYLGHAU [n]
NILGHAI	(Hindi) a kind of antelope, also NILGAI, NILGAU, NILGHAU, NYLGHAI, NYLGHAU [n -S]
NILGHAIS	NILGHAI, (Hindi) a kind of antelope, also NILGAI, NILGAU, NILGHAU, NYLGHAI, NYLGHAU [n]
NILGHAU	(Hindi) a kind of antelope, also NILGAI, NILGAU, NILGHAI, NYLGHAI, NYLGHAU [n -S]
NILGHAUS	NILGHAU, (Hindi) a kind of antelope, also NILGAI, NILGAU, NILGHAI, NYLGHAI, NYLGHAU [n]
NIMB	(Hindi) an East Indian tree yielding an aromatic oil, also NEEM, NEEMB [n -S]
NIMBS	NIMB, (Hindi) an East Indian tree yielding an aromatic oil, also NEEM, NEEMB [n]
NIRVANA	(Sanskrit) freedom from the endless cycle of birth and death and related suffering, in Hindu and Buddhist religions [n -S]
NIRVANAS	NIRVANA, (Sanskrit) freedom from the endless cycle of birth and death and related suffering, in Hindu and Buddhist religions [n]
NIZAM	(Hindi) the title of the native sovereigns of Hyderabad, in India, since 1719 [n -S]
NIZAMATE	(Hindi) the territory of a nizam [n -S]
NIZAMATES	NIZAMATE, (Hindi) the territory of a nizam [n]
NIZAMS	NIZAM, (Hindi) the title of the native sovereigns of Hyderabad, in India, since 1719 [n]
NOTEBANDI	(Hindi) (in India) the withdrawal of certain banknotes from use as currency; demonetization [n -S]
NOTEBANDIS	NOTEBANDI, (Hindi) (in India) the withdrawal of certain banknotes from use as currency; demonetization [n]
NULLA	(Hindi) a ravine, a watercourse, also NALA, NALLA, NALLAH, NULLAH [n -S]
NULLAH	(Hindi) a ravine, a watercourse, also NALA, NALLA, NALLAH, NULLA [n -S]
NULLAHS	NULLAH, (Hindi) a ravine, a watercourse, also NALA, NALLA, NALLAH, NULLA [n]
NULLAS	NULLA, (Hindi) a ravine, a watercourse, also NALA, NALLA, NALLAH, NULLAH [n]
NUMDAH	(Urdu) an embroidered felt rug made in India [n -S]
NUMDAHS	NUMDAH, (Urdu) an embroidered felt rug made in India [n]
NUMNAH	(Urdu) a pad under the saddle to prevent chafing [n -S]
NUMNAHS	NUMNAH, (Urdu) a pad under the saddle to prevent chafing [n]
NUZZER	(Hindi) a present to a superior [n -S]
NUZZERS	NUZZER, (Hindi) a present to a superior [n]
NYLGHAI	(Hindi) a large antelope, also NILGAI, NILGAU, NILGHAI, NILGHAU, NYLGHAU [n -S]
NYLGHAIS	NYLGHAI, (Hindi) a large antelope, also NILGAI, NILGAU, NILGHAI, NILGHAU, NYLGHAU [n]
NYLGHAU	(Hindi) a large antelope, also NILGAI, NILGAU, NILGHAI, NILGHAU, NYLGHAI [n -S]
NYLGHAUS	NYLGHAU, (Hindi) a large antelope, also NILGAI, NILGAU, NILGHAI, NILGHAU, NYLGHAI [n]
OM	an intoned Hindu sacred symbol [n -S]
OMLAH	(Arabic) an Indian staff of officials [n -S]
OMLAHS	OMLAH, (Arabic) an Indian staff of officials [n]
OMRAH	(Hindi) a Muslim lord [n -S]
OMRAHS	OMRAH, (Hindi) a Muslim lord [n]
OMS	OM, an intoned Hindu sacred symbol [n]
OONT	(Hindi) a camel [n -S]
OONTS	OONT, (Hindi) a camel [n]
OORIAL	(Punjabi) a kind of Himalayan sheep, also URIAL [n -S]
OORIALS	OORIAL, (Punjabi) a kind of Himalayan sheep, also URIAL [n]
OPUNTIA	(Latin) a genus of cactaceous plants, the prickly pear, or Indian fig [n -S]
OPUNTIAS	OPUNTIA, (Latin) a genus of cactaceous plants, the prickly pear, or Indian fig [n]
PACHAK	(Hindi) an aromatic root resembling ginger, also PUTCHOCK, PUTCHUK [n -S]
PACHAKS	PACHAK, (Hindi) an aromatic root resembling ginger, also PUTCHOCK, PUTCHUK [n]
PACHISI	(Hindi) an Indian board game, also PARCHESI, PARCHISI [n -S]
PACHISIS	PACHISI, (Hindi) an Indian board game, also PARCHESI, PARCHISI [n]
PACHOULI	(Tamil) an Asiatic tree with a fragrant perfume oil; the resulting perfume, also PATCHOULI, PATCHOULY [n -S]
PACHOULIS	PACHOULI, (Tamil) an Asiatic tree with a fragrant perfume oil; the resulting perfume, also PATCHOULI, PATCHOULY [n]
PADMA	(Sanskrit) the sacred lotus [n -S]
PADMAS	PADMA, (Sanskrit) the sacred lotus [n]
PAGRI	(Hindi) a turban, a light scarf worn round a hat to keep out the sun, also PUGAREE, PUGGAREE, PUGGERY, PUGGREE, PUGGRY, PUGREE [n -S]
PAGRIS	PAGRI, (Hindi) a turban, a light scarf worn round a hat to keep out the sun, also PUGAREE, PUGGAREE, PUGGERY, PUGGREE, PUGGRY, PUGREE [n]
PAISA	(Hindi) an Indian coin, 1/100 of a rupee [n PAISE or PAISAS]
PAISAS	PAISA, (Hindi) an Indian coin, 1/100 of a rupee [n]
PAISE	PAISA, (Hindi) an Indian coin, 1/100 of a rupee [n]
PAKKA	(Hindi) genuine; first-class, also PUCKA, PUKKA, PUKKAH [adj]
PAKORA	(Hindi) an Indian dish of chopped vegetables fried in batter [n -S]
PAKORAS	PAKORA, (Hindi) an Indian dish of chopped vegetables fried in batter [n]
PALAS	(Hindi) a leguminous tree of eastern India and Myanmar, the dhak trees [n -ES]
PALASES	PALAS, (Hindi) a leguminous tree of eastern India and Myanmar, the dhak trees [n]
PALAY	(Tamil) the ivory tree, a small South Indian tree of the dogbane family [n -S]
PALAYS	PALAY, (Tamil) the ivory tree, a small South Indian tree of the dogbane family [n]
PALKEE	(Hindi) a palanquin, also PALKI [n -S]
PALKEES	PALKEE, (Hindi) a palanquin, also PALKI [n]
PALKI	(Hindi) a palanquin, also PALKEE [n -S]
PALKIS	PALKI, (Hindi) a palanquin, also PALKEE [n]
PANCHAYAT	(Hindi) five elders, a council of five that is the basis for Indian village government [n -S]
PANCHAYATS	PANCHAYAT, (Hindi) five elders, a council of five that is the basis for Indian village government [n]
PANDA	(Nepali) a raccoon-like animal of the Himalayas; a similar but much larger bearlike animal of Tibet and China [n -S]
PANDAS	PANDA, (Nepali) a raccoon-like animal of the Himalayas; a similar but much larger bearlike animal of Tibet and China [n]
PANDIT	(Sanskrit) a Hindu learned in Sanskrit, also PUNDIT [n -S]
PANDITS	PANDIT, (Sanskrit) a Hindu learned in Sanskrit, also PUNDIT [n]
PANEER	(Hindi) a soft white cheese used in Indian cookery [n -S]
PANEERS	PANEER, (Hindi) a soft white cheese used in Indian cookery [n]
PAPADAM	(Tamil) a thin circle of dough fried in oil until crisp, also PAPADOM, PAPADUM, PAPPADAM, PAPPADOM, PAPPADUM, POPADUM, POPPADOM, POPPADUM, PUPPODUM [n -S]
PAPADAMS	PAPADAM, (Tamil) a thin circle of dough fried in oil until crisp, also PAPADOM, PAPADUM, PAPPADAM, PAPPADOM, PAPPADUM, POPADUM, POPPADOM, POPPADUM, PUPPODUM [n]
PAPADOM	(Tamil) a thin circle of dough fried in oil until crisp, also PAPADAM, PAPADUM, PAPPADAM, PAPPADOM, PAPPADUM, POPADUM, POPPADOM, POPPADUM, PUPPODUM [n -S]
PAPADOMS	PAPADOM, (Tamil) a thin circle of dough fried in oil until crisp, also PAPADAM, PAPADUM, PAPPADAM, PAPPADOM, PAPPADUM, POPADUM, POPPADOM, POPPADUM, PUPPODUM [n]
PAPADUM	(Tamil) a thin circle of dough fried in oil until crisp, also PAPADAM, PAPADOM, PAPPADAM, PAPPADOM, PAPPADUM, POPADUM, POPPADOM, POPPADUM, PUPPODUM [n -S]
PAPADUMS	PAPADUM, (Tamil) a thin circle of dough fried in oil until crisp, also PAPADAM, PAPADOM, PAPPADAM, PAPPADOM, PAPPADUM, POPADUM, POPPADOM, POPPADUM, PUPPODUM [n]
PAPPADAM	(Tamil) a thin circle of dough fried in oil until crisp, also PAPADAM, PAPADOM, PAPADUM, PAPPADOM, PAPPADUM, POPADUM, POPPADOM, POPPADUM, PUPPODUM [n -S]
PAPPADAMS	PAPPADAM, (Tamil) a thin circle of dough fried in oil until crisp, also PAPADAM, PAPADOM, PAPADUM, PAPPADOM, PAPPADUM, POPADUM, POPPADOM, POPPADUM, PUPPODUM [n]
PAPPADOM	(Tamil) a thin circle of dough fried in oil until crisp, also PAPADAM, PAPADOM, PAPADUM, PAPPADAM, PAPPADUM, POPADUM, POPPADOM, POPPADUM, PUPPODUM [n -S]
PAPPADOMS	PAPPADOM, (Tamil) a thin circle of dough fried in oil until crisp, also PAPADAM, PAPADOM, PAPADUM, PAPPADAM, PAPPADUM, POPADUM, POPPADOM, POPPADUM, PUPPODUM [n]
PAPPADUM	(Tamil) a thin circle of dough fried in oil until crisp, also PAPADAM, PAPADOM, PAPADUM, PAPPADAM, PAPPADOM, POPADUM, POPPADOM, POPPADUM, PUPPODUM [n -S]
PAPPADUMS	PAPPADUM, (Tamil) a thin circle of dough fried in oil until crisp, also PAPADAM, PAPADOM, PAPADUM, PAPPADAM, PAPPADOM, POPADUM, POPPADOM, POPPADUM, PUPPODUM [n]
PARATHA	(Hindi) a flat round cake of unleavened bread, traditionally eaten as an accompaniment to Indian food [n -S]
PARATHAS	PARATHA, (Hindi) a flat round cake of unleavened bread, traditionally eaten as an accompaniment to Indian food [n]
PARCHEESI	(Hindi) a game, somewhat resembling backgammon, originating in India, also PACHISI, PARCHESI, PARCHISI [n -S]
PARCHEESIS	PARCHEESI, (Hindi) a game, somewhat resembling backgammon, originating in India, also PACHISI, PARCHESI, PARCHISI [n]
PARCHESI	(Hindi) a game, somewhat resembling backgammon, originating in India, also PACHISI, PARCHEESI, PARCHISI [n -S]
PARCHESIS	PARCHESI, (Hindi) a game, somewhat resembling backgammon, originating in India, also PACHISI, PARCHEESI, PARCHISI [n]
PARCHISI	(Hindi) a game, somewhat resembling backgammon, originating in India, also PACHISI, PARCHEESI, PARCHESI [n -S]
PARCHISIS	PARCHISI, (Hindi) a game, somewhat resembling backgammon, originating in India, also PACHISI, PARCHEESI, PARCHESI [n]
PARDAH	(Urdu) the seclusion of women from public observation among Muslims and some Hindus, also PURDA, PURDAH [n -S]
PARDAHS	PARDAH, (Urdu) the seclusion of women from public observation among Muslims and some Hindus, also PURDA, PURDAH [n]
PARGANA	(Hindi) a division of an administrative district or zillah in India, also PERGUNNAH [n -S]
PARGANAS	PARGANA, (Hindi) a division of an administrative district or zillah in India, also PERGUNNAH [n]
PARIAH	(Tamil) a person of low or no caste; a social outcast [n -S]
PARIAHS	PARIAH, (Tamil) a person of low or no caste; a social outcast [n]
PARISHAD	(Hindi) an Indian assembly [n -S]
PARISHADS	PARISHAD, (Hindi) an Indian assembly [n]
PASHIM	(Persian) the fine under-fleece of the goats of North India, used for making rugs, shawls etc., also PASHM [n -S]
PASHIMS	PASHIM, (Persian) the fine under-fleece of the goats of North India, used for making rugs, shawls etc., also PASHM [n]
PASHM	(Persian) the fine under-fleece of the goats of North India, used for making rugs, shawls etc., also PASHIM [n -S]
PASHMINA	(Persian) a shawl made from pashm, the fine under-fleece of the goats of North India [n -S]
PASHMINAS	PASHMINA, (Persian) a shawl made from pashm, the fine under-fleece of the goats of North India [n]
PASHMS	PASHM, (Persian) the fine under-fleece of the goats of North India, used for making rugs, shawls etc., also PASHIM [n]
PATCHOULI	(Tamil) an Asiatic tree with a fragrant perfume oil; the resulting perfume, also PACHOULI, PATCHOULY [n -S]
PATCHOULIES	PATCHOULY, (Tamil) an Asiatic tree with a fragrant perfume oil; the resulting perfume, also PACHOULI, PATCHOULI [n]
PATCHOULIS	PATCHOULI, (Tamil) an Asiatic tree with a fragrant perfume oil; the resulting perfume, also PACHOULI, PATCHOULY [n]
PATCHOULY	(Tamil) an Asiatic tree with a fragrant perfume oil; the resulting perfume, also PACHOULI, PATCHOULI [n PATCHOULIES]
PATKA	a scarf worn as a head-covering by Sikh men in place of a turban [n -S]
PATKAS	PATKA, a scarf worn as a head-covering by Sikh men in place of a turban [n]
PEEPAL	(Hindi) a fig tree from India, aka bo tree, also PEEPUL, PIPAL, PIPUL [n -S]
PEEPALS	PEEPAL, (Hindi) a fig tree from India, aka bo tree, also PEEPUL, PIPAL, PIPUL [n]
PEEPUL	(Hindi) a fig tree from India, aka bo tree, also PIPAL, PIPUL [n -S]
PEEPULS	PEEPUL, (Hindi) a fig tree from India, aka bo tree, also PIPAL, PIPUL [n]
PENDU	(Hinglish) culturally backward [adj]
PERGUNNAH	(Hindi) a division of an administrative district or zillah in India, also PARGANA [n -S]
PERGUNNAHS	PERGUNNAH, (Hindi) a division of an administrative district or zillah in India, also PARGANA [n]
PETARA	(Hindi) in India, a travelling box for clothes, also PITARA, PITARAH [n -S]
PETARAS	PETARA, (Hindi) in India, a travelling box for clothes, also PITARA, PITARAH [n]
PHANSIGAR	(Hindi) formerly in India, a Thug [n -S]
PHANSIGARS	PHANSIGAR, (Hindi) formerly in India, a Thug [n]
PICE	(Hindi) an Indian coin, 1/4 anna [n PICE]
PINDAREE	(Hindi) an Indian mercenary, also PINDARI [n -S]
PINDAREES	PINDAREE, (Hindi) an Indian mercenary, also PINDARI [n]
PINDARI	(Hindi) an Indian mercenary, also PINDAREE [n -S]
PINDARIS	PINDARI, (Hindi) an Indian mercenary, also PINDAREE [n]
PIPAL	(Hindi) the bo tree, also PEEPUL, PIPUL [n -S]
PIPALS	PIPAL, (Hindi) the bo tree, also PEEPUL, PIPUL [n]
PIPUL	(Hindi) a fig tree from India, also PIPAL, PEEPUL [n -S]
PIPULS	PIPUL, (Hindi) a fig tree from India, also PIPAL, PEEPUL [n]
PITARA	(Hindi) a type of clothes basket, also PETARA, PITARAH [n -S]
PITARAH	(Hindi) a type of clothes basket, also PETARA, PITARA [n -S]
PITARAHS	PITARAH, (Hindi) a type of clothes basket, also PETARA, PITARA [n]
PITARAS	PITARA, (Hindi) a type of clothes basket, also PETARA, PITARAH [n]
POISHA	(Bengali) a Bangladeshi monetary unit [n -S]
POISHAS	POISHA, (Bengali) a Bangladeshi monetary unit [n]
POMFRET	(Portuguese) a sea fish found along the Indian coasts [n -S]
POMFRETS	POMFRET, (Portuguese) a sea fish found along the Indian coasts [n]
PONGAL	a dish of cooked rice in Tamil-speaking India [n -S]
PONGALS	PONGAL, a dish of cooked rice in Tamil-speaking India [n]
POOGYE	(Hindi) an Indian nose-flute [n -S]
POOGYES	POOGYE, (Hindi) an Indian nose-flute [n]
POOJA	(Sanskrit) a Hindu worship practice, also POOJAH, PUJA, PUJAH [n -S]
POOJAH	(Sanskrit) a Hindu worship practice, also POOJA, PUJA, PUJAH [n -S]
POOJAHS	POOJAH, (Sanskrit) a Hindu worship practice, also POOJA, PUJA, PUJAH [n]
POOJAS	POOJA, (Sanskrit) a Hindu worship practice, also POOJAH, PUJA, PUJAH [n]
POONAC	(Tamil) a kind of oil cake prepared from the coconut, and fed to cattle [n -S]
POONACS	POONAC, (Tamil) a kind of oil cake prepared from the coconut, and fed to cattle [n]
POORI	(Hindi) in India, a small cake of unleavened bread fried in vegetable oil, also PURI [n -S]
POORIS	POORI, (Hindi) in India, a small cake of unleavened bread fried in vegetable oil, also PURI [n]
POPADUM	(Tamil) a thin circle of dough fried in oil until crisp, also PAPADAM, PAPADOM, PAPADUM, PAPPADAM, PAPPADOM, PAPPADUM, POPPADOM, POPPADUM, PUPPODUM [n -S]
POPADUMS	POPADUM, (Tamil) a thin circle of dough fried in oil until crisp, also PAPADAM, PAPADOM, PAPADUM, PAPPADAM, PAPPADOM, PAPPADUM, POPPADOM, POPPADUM, PUPPODUM [n]
POPCORN	maize or Indian corn, the kernels of which swell up and burst open with a small explosive sound when heated [n -S]
POPCORNS	POPCORN, maize or Indian corn, the kernels of which swell up and burst open with a small explosive sound when heated [n]
POPPADOM	(Tamil) a thin circle of dough fried in oil until crisp, also PAPADAM, PAPADOM, PAPADUM, PAPPADAM, PAPPADOM, PAPPADUM, POPADUM, POPPADUM, PUPPODUM [n -S]
POPPADOMS	POPPADOM, (Tamil) a thin circle of dough fried in oil until crisp, also PAPADAM, PAPADOM, PAPADUM, PAPPADAM, PAPPADOM, PAPPADUM, POPADUM, POPPADUM, PUPPODUM [n]
POPPADUM	(Tamil) a thin circle of dough fried in oil until crisp, also PAPADAM, PAPADOM, PAPADUM, PAPPADAM, PAPPADOM, PAPPADUM, POPADUM, POPPADOM, PUPPODUM [n -S]
POPPADUMS	POPPADUM, (Tamil) a thin circle of dough fried in oil until crisp, also PAPADAM, PAPADOM, PAPADUM, PAPPADAM, PAPPADOM, PAPPADUM, POPADUM, POPPADOM, PUPPODUM [n]
PRACHARAK	(Hindi) in India, a person appointed to propagate a cause through personal contacts, meetings etc. [n -S]
PRACHARAKS	PRACHARAK, (Hindi) in India, a person appointed to propagate a cause through personal contacts, meetings etc. [n]
PRADHAN	(Hindi) (in India) a chief or leader [n -S]
PRADHANS	PRADHAN, (Hindi) (in India) a chief or leader [n]
PRAJNA	(Sanskrit) wisdom or understanding considered as the goal of Buddhist contemplation [n -S]
PRAJNAS	PRAJNA, (Sanskrit) wisdom or understanding considered as the goal of Buddhist contemplation [n]
PRANA	(Sanskrit) in yoga, vital energy present in air and sunlight [n -S]
PRANAS	PRANA, (Sanskrit) in yoga, vital energy present in air and sunlight [n]
PRANAYAM	(Sanskrit) the discipline of yogic breathing, also PRANAYAMA [n -S]
PRANAYAMA	(Sanskrit) the discipline of yogic breathing, also PRANAYAM [n -S]
PRANAYAMAS	PRANAYAMA, (Sanskrit) the discipline of yogic breathing, also PRANAYAM [n]
PRANAYAMS	PRANAYAM, (Sanskrit) the discipline of yogic breathing, also PRANAYAMA [n]
PUCKA	(Hindi) genuine; first-class, also PAKKA, PUKKA, PUKKAH [adj]
PUEBLO	(Spanish) a communal dwelling of certain Indian tribes [n -S]
PUEBLOS	PUEBLO, (Spanish) a communal dwelling of certain Indian tribes [n]
PUGAREE	(Hindi) a turban, a light scarf worn round a hat to keep out the sun, also PAGRI, PUGGAREE, PUGGERY, PUGGREE, PUGGRY, PUGREE [n -S]
PUGAREES	PUGAREE, (Hindi) a turban, a light scarf worn round a hat to keep out the sun, also PAGRI, PUGGAREE, PUGGERY, PUGGREE, PUGGRY, PUGREE [n]
PUGGAREE	(Hindi) a turban, a light scarf worn round a hat to keep out the sun, also PAGRI, PUGAREE, PUGGERY, PUGGREE, PUGGRY, PUGREE [n -S]
PUGGAREES	PUGGAREE, (Hindi) a turban, a light scarf worn round a hat to keep out the sun, also PAGRI, PUGAREE, PUGGERY, PUGGREE, PUGGRY, PUGREE [n]
PUGGERIES	PUGGERY, (Hindi) a turban, a light scarf worn round a hat to keep out the sun, also PAGRI, PUGAREE, PUGGAREE, PUGGREE, PUGGRY, PUGREE [n]
PUGGERY	(Hindi) a turban, a light scarf worn round a hat to keep out the sun, also PAGRI, PUGAREE, PUGGAREE, PUGGREE, PUGGRY, PUGREE [n PUGGERIES]
PUGGREE	(Hindi) a turban, a light scarf worn round a hat to keep out the sun, also PAGRI, PUGAREE, PUGGAREE, PUGGERY, PUGGRY, PUGREE [n -S]
PUGGREES	PUGGREE, (Hindi) a turban, a light scarf worn round a hat to keep out the sun, also PAGRI, PUGAREE, PUGGAREE, PUGGERY, PUGGRY, PUGREE [n]
PUGGRIES	PUGGRY, (Hindi) a turban, a light scarf worn round a hat to keep out the sun, also PAGRI, PUGAREE, PUGGAREE, PUGGERY, PUGGREE, PUGREE [n]
PUGGRY	(Hindi) a turban, a light scarf worn round a hat to keep out the sun, also PAGRI, PUGAREE, PUGGAREE, PUGGERY, PUGGREE, PUGREE [n PUGGRIES]
PUGREE	(Hindi) a turban, a light scarf worn round a hat to keep out the sun, also PAGRI, PUGAREE, PUGGAREE, PUGGERY, PUGGREE, PUGGRY [n -S]
PUGREES	PUGREE, (Hindi) a turban, a light scarf worn round a hat to keep out the sun, also PAGRI, PUGAREE, PUGGAREE, PUGGERY, PUGGREE, PUGGRY [n]
PUJA	(Sanskrit) a Hindu worship practice, also POOJA, POOJAH, PUJAH [n -S]
PUJAH	(Sanskrit) a Hindu act of worship or prayer, also POOJA, POOJAH, PUJA [n -S]
PUJAHS	PUJAH, (Sanskrit) a Hindu act of worship or prayer, also POOJA, POOJAH, PUJA [n]
PUJARI	(Hindu) a priest [n -S]
PUJARIS	PUJARI, (Hindu) a priest [n]
PUJAS	PUJA, (Sanskrit) a Hindu worship practice, also POOJA, POOJAH, PUJAH [n]
PUKKA	(Hindi) genuine; first-class, also PAKKA, PUCKA, PUKKAH [adj]
PULTAN	(Hindi) an Indian regiment, also PULTUN, PULTON, PULTOON [n -S]
PULTANS	PULTAN, (Hindi) an Indian regiment, also PULTUN, PULTON, PULTOON [n]
PULTON	(Hindi) an Indian regiment, also PULTUN, PULTAN, PULTOON [n -S]
PULTONS	PULTON, (Hindi) an Indian regiment, also PULTUN, PULTAN, PULTOON [n]
PULTOON	(Hindi) an Indian regiment, also PULTUN, PULTAN, PULTON [n -S]
PULTOONS	PULTOON, (Hindi) an Indian regiment, also PULTUN, PULTAN, PULTON [n]
PULTUN	(Hindi) an Indian regiment, also PULTAN, PULTON, PULTOON [n -S]
PULTUNS	PULTUN, (Hindi) an Indian regiment, also PULTAN, PULTON, PULTOON [n]
PULWAR	(Hindi) a light keelless boat used on the Ganges [n -S]
PULWARS	PULWAR, (Hindi) a light keelless boat used on the Ganges [n]
PUNDIT	(Sanskrit) a learned person, an expert; originally a Hindu learned in Sanskrit, also PANDIT [n -S]
PUNDITS	PUNDIT, (Sanskrit) a learned person, an expert; originally a Hindu learned in Sanskrit, also PANDIT [n]
PUNKA	(Hindi) a large palm-leaf fan suspended from the ceiling used especially in India, also PUNKAH [n -S]
PUNKAH	(Hindi) a large palm-leaf fan suspended from the ceiling used especially in India, also PUNKA [n -S]
PUNKAHS	PUNKAH, (Hindi) a large palm-leaf fan suspended from the ceiling used especially in India, also PUNKA [n]
PUNKAS	PUNKA, (Hindi) a large palm-leaf fan suspended from the ceiling used especially in India, also PUNKAH [n]
PUPPODUM	(Tamil) a thin circle of dough fried in oil until crisp, also PAPADAM, PAPADOM, PAPADUM, PAPPADAM, PAPPADOM, PAPPADUM, POPADUM, POPPADOM, POPPADUM [n -S]
PUPPODUMS	PUPPODUM, (Tamil) a thin circle of dough fried in oil until crisp, also PAPADAM, PAPADOM, PAPADUM, PAPPADAM, PAPPADOM, PAPPADUM, POPADUM, POPPADOM, POPPADUM [n]
PURANA	(Sanskrit) any one of a class of sacred books of Hindu mythology, cosmology, etc. written in Sanskrit [n -S]
PURANAS	PURANA, (Sanskrit) any one of a class of sacred books of Hindu mythology, cosmology, etc. written in Sanskrit [n]
PURANIC	(Sanskrit) pertaining to the Puranas, the Hindu sacred books [adj]
PURDA	(Urdu) seclusion of women from public observation among Muslims and some Hindus, also PARDAH, PURDAH [n -S]
PURDAH	(Urdu) seclusion of women from public observation among Muslims and some Hindus, also PARDAH, PURDA [n -S]
PURDAHS	PURDAH, (Urdu) seclusion of women from public observation among Muslims and some Hindus, also PARDAH, PURDA [n]
PURDAS	PURDA, (Urdu) seclusion of women from public observation among Muslims and some Hindus, also PARDAH, PURDAH [n]
PURI	(Hindi) in India, a small cake of unleavened bread fried in vegetable oil, also POORI [n -S]
PURIS	PURI, (Hindi) in India, a small cake of unleavened bread fried in vegetable oil, also POORI [n]
PUTCHOCK	(Hindi) an aromatic root resembling ginger, also PACHAK, PUTCHUK [n -S]
PUTCHOCKS	PUTCHOCK, (Hindi) an aromatic root resembling ginger, also PACHAK, PUTCHUK [n]
PUTCHUK	(Hindi) an aromatic root resembling ginger, also PUTCHOCK, PACHAK [n -S]
PUTCHUKS	PUTCHUK, (Hindi) an aromatic root resembling ginger, also PUTCHOCK, PACHAK [n]
PUTELI	(Hindi) a flat-bottomed boat used on the Ganges [n -S]
PUTELIS	PUTELI, (Hindi) a flat-bottomed boat used on the Ganges [n]
PUTTEE	(Hindi) a long strip of cloth wound round the lower leg, especially as part of army uniform, also PUTTIE [n -S]
PUTTEES	PUTTEE, (Hindi) a long strip of cloth wound round the lower leg, especially as part of army uniform, also PUTTIE [n]
PUTTIE	(Hindi) a long strip of cloth wound round the lower leg, especially as part of army uniform, also PUTTEE [n -S]
QAMEEZ	(Urdu) in South Asia, a loose tunic, worn by women, also KAMEES, KAMEEZ [n -ES]
QAMEEZES	QAMEEZ, (Urdu) in South Asia, a loose tunic, worn by women, also KAMEES, KAMEEZ [n]
QEEMA	(Hindi) in Indian cookery, minced beef, also KEEMA, KHEEMA [n -S]
QEEMAS	QEEMA, (Hindi) in Indian cookery, minced beef, also KEEMA, KHEEMA [n]
QORMA	(Hindi) a mild curry, also KORMA [n -S]
QORMAS	QORMA, (Hindi) a mild curry, also KORMA [n]
RABI	(Urdu) the spring grain harvest in India and Pakistan [n -S]
RABIS	RABI, (Urdu) the spring grain harvest in India and Pakistan [n]
RAGA	(Sanskrit) an Indian musical form [n -S]
RAGAS	RAGA, (Sanskrit) an Indian musical form [n]
RAGEE	(Hindi) a kind of millet, also RAGGEE, RAGGY, RAGI [n -S]
RAGEES	RAGEE, (Hindi) a kind of millet, also RAGGEE, RAGGY, RAGI [n]
RAGGEE	(Hindi) a kind of millet, also RAGEE, RAGGY, RAGI [n -S]
RAGGEES	RAGGEE, (Hindi) a kind of millet, also RAGEE, RAGGY, RAGI [n]
RAGI	(Hindi) a kind of millet, also RAGEE, RAGGEE, RAGGY [n -S]
RAGINI	(Sanskrit) a modified raga [n -S]
RAGINIS	RAGINI, (Sanskrit) a modified raga [n]
RAGIS	RAGI, (Hindi) a kind of millet, also RAGEE, RAGGEE, RAGGY [n]
RAITA	(Hindi) an Indian dish of chopped vegetables in yogurt [n -S]
RAITAS	RAITA, (Hindi) an Indian dish of chopped vegetables in yogurt [n]
RAIYAT	(Hindi) an Indian peasant, also RYOT [n -S]
RAIYATS	RAIYAT, (Hindi) an Indian peasant, also RYOT [n]
RAIYATWARI	(Hindi) a system of peasantry in India, also RYOTWARI [n -S]
RAIYATWARIS	RAIYATWARI, (Hindi) a system of peasantry in India, also RYOTWARI [n]
RAJ	in India, sovereignty [n -ES]
RAJA	(Hindi) an Indian ruler, also RAJAH [n -S]
RAJAH	(Hindi) an Indian ruler, also RAJA [n -S]
RAJAHS	RAJAH, (Hindi) an Indian ruler, also RAJA [n]
RAJAS	RAJA, (Hindi) an Indian ruler, also RAJAH [n]
RAJES	RAJ, in India, sovereignty [n]
RAJPRAMUKH	(Hindi) the head of a state or states union in the Democratic Republic of India [n -S]
RAJPRAMUKHS	RAJPRAMUKH, (Hindi) the head of a state or states union in the Democratic Republic of India [n]
RAKSHAS	(Sanskrit) in Hindu mythology, an evil spirit, also RAKSHASA [n -ES]
RAKSHASA	(Sanskrit) in Hindu mythology, an evil spirit, also RAKSHAS [n -S]
RAKSHASAS	RAKSHASA, (Sanskrit) in Hindu mythology, an evil spirit, also RAKSHAS [n]
RAKSHASES	RAKSHAS, (Sanskrit) in Hindu mythology, an evil spirit, also RAKSHASA [n]
RAMTIL	(Bengali) a plant of the Indian subcontinent, cultivated for the oil pressed from the seeds, also RAMTILLA [n -S]
RAMTILLA	(Bengali) a plant of the Indian subcontinent, cultivated for the oil pressed from the seeds, also RAMTIL [n -S]
RAMTILLAS	RAMTILLA, (Bengali) a plant of the Indian subcontinent, cultivated for the oil pressed from the seeds, also RAMTIL [n]
RAMTILS	RAMTIL, (Bengali) a plant of the Indian subcontinent, cultivated for the oil pressed from the seeds, also RAMTILLA [n]
RANA	(Hindi) a Rajput prince [n -S]
RANAS	RANA, (Hindi) a Rajput prince [n]
RANCHERIA	(Spanish) in Spanish America and the western US, a collection of Indian huts; a place or house where a number of rancheros live [n -S]
RANCHERIAS	RANCHERIA, (Spanish) in Spanish America and the western US, a collection of Indian huts; a place or house where a number of rancheros live [n]
RANCHERIE	a Canadian Indian village or settlement, esp. on a reserve [n -S]
RANCHERIES	RANCHERIE, a Canadian Indian village or settlement, esp. on a reserve [n]
RANEE	(Hindi) the wife of a rajah, also RANI [n -S]
RANEES	RANEE, (Hindi) the wife of a rajah, also RANI [n]
RANGOLI	(Hindi) a traditional Hindu form of decoration on floors and doorsteps, forming patterns of coloured sand and rice flour [n -S]
RANGOLIS	RANGOLI, (Hindi) a traditional Hindu form of decoration on floors and doorsteps, forming patterns of coloured sand and rice flour [n]
RANI	(Hindi) the wife of a rajah, also RANEE [n -S]
RANIS	RANI, (Hindi) the wife of a rajah, also RANEE [n]
RASMALAI	(Hindi) an Indian dessert made of cheese, milk and almonds [n -S]
RASMALAIS	RASMALAI, (Hindi) an Indian dessert made of cheese, milk and almonds [n]
RATHA	(Hindi) a four-wheeled carriage drawn by horses or bullocks [n -S]
RATHAS	RATHA, (Hindi) a four-wheeled carriage drawn by horses or bullocks [n]
REGAR	(Hindi) the rich black cotton soil of the Indian subcontinent, also REGUR [n -S]
REGARS	REGAR, (Hindi) the rich black cotton soil of the Indian subcontinent, also REGUR [n]
REGUR	(Hindi) the rich black cotton soil of the Indian subcontinent, also REGAR [n -S]
REGURS	REGUR, (Hindi) the rich black cotton soil of the Indian subcontinent, also REGAR [n]
RESSALDAR	(Urdu) an Indian troop commander, also RISALDAR [n -S]
RESSALDARS	RESSALDAR, (Urdu) an Indian troop commander, also RISALDAR [n]
RHANJA	(Hinglish) a male lover [n -S]
RHANJAS	RHANJA, (Hinglish) a male lover [n]
RISALDAR	(Urdu) an Indian troop commander, also RESSALDAR [n -S]
RISALDARS	RISALDAR, (Urdu) an Indian troop commander, also RESSALDAR [n]
RISHI	(Sanskrit) a sage or poet [n -S]
RISHIS	RISHI, (Sanskrit) a sage or poet [n]
ROMAL	(Urdu) a handkerchief or headcloth, also RUMAL [n -S]
ROMALS	ROMAL, (Urdu) a handkerchief or headcloth, also RUMAL [n]
ROOSA	(Hindi) an Indian grass [n -S]
ROOSAS	ROOSA, (Hindi) an Indian grass [n]
ROSELLE	an East Indian hibiscus, also ROZELLE [n -S]
ROSELLES	ROSELLE, an East Indian hibiscus, also ROZELLE [n]
ROTI	(Hindi) a cake of unleavened bread [n -S]
ROTIS	ROTI, (Hindi) a cake of unleavened bread [n]
ROZELLE	an East Indian hibiscus, also ROSELLE [n -S]
ROZELLES	ROZELLE, an East Indian hibiscus, also ROSELLE [n]
RUMAL	(Urdu) a handkerchief or headcloth, also ROMAL [n -S]
RUMALS	RUMAL, (Urdu) a handkerchief or headcloth, also ROMAL [n]
RUPEE	(Hindi) a monetary unit of India [n -S]
RUPEES	RUPEE, (Hindi) a monetary unit of India [n]
RUPIAH	(Hindi) a monetary unit of Indonesia [n -S]
RUPIAHS	RUPIAH, (Hindi) a monetary unit of Indonesia [n]
RUSA	(Hindi) an East Indian deer [n -S]
RUSAS	RUSA, (Hindi) an East Indian deer [n]
RUSINE	pertaining to a deer of the genus Rusa, which includes the sambur deer of India [adj]
RYOT	(Hindi) an Indian peasant, also RAIYAT [n -S]
RYOTS	RYOT, (Hindi) an Indian peasant, also RAIYAT [n]
RYOTWARI	(Hindi) a system of peasantry in India, also RAIYATWARI [n -S]
RYOTWARIS	RYOTWARI, (Hindi) a system of peasantry in India, also RAIYATWARI [n]
SAAG	(Hindi) in Indian cookery, spinach [n -S]
SAAGS	SAAG, (Hindi) in Indian cookery, spinach [n]
SACHEMIC	relating to a sachem, an Indian chief [adj]
SADDHU	(Sanskrit) an ascetic Indian holy man, also SADHU [n -S]
SADDHUS	SADDHU, (Sanskrit) an ascetic Indian holy man, also SADHU [n]
SADHANA	(Hindi) one of a number of spiritual practices or disciplines which lead to perfection [n -S]
SADHANAS	SADHANA, (Hindi) one of a number of spiritual practices or disciplines which lead to perfection [n]
SADHU	(Sanskrit) an ascetic Indian holy man, also SADDHU [n -S]
SADHUS	SADHU, (Sanskrit) an ascetic Indian holy man, also SADDHU [n]
SAHEB	(Hindi) a term of respect in colonial India, also SAHIB [n -S]
SAHEBS	SAHEB, (Hindi) a term of respect in colonial India, also SAHIB [n]
SAHIB	(Hindi) a term of respect in colonial India, also SAHEB [n -S]
SAHIBA	(Hindi) a lady sahib, also SAHIBAH [n -S]
SAHIBAH	(Hindi) a lady sahib, also SAHIBA [n -S]
SAHIBAHS	SAHIBAH, (Hindi) a lady sahib, also SAHIBA [n]
SAHIBAS	SAHIBA, (Hindi) a lady sahib, also SAHIBAH [n]
SAHIBS	SAHIB, (Hindi) a term of respect in colonial India, also SAHEB [n]
SAHIWAL	(Punjabi) any of a breed of humped dairy cattle [n -S]
SAHIWALS	SAHIWAL, (Punjabi) any of a breed of humped dairy cattle [n]
SAICE	(Arabic) a male servant in India, also SYCE, SICE [n -S]
SAICES	SAICE, (Arabic) a male servant in India, also SYCE, SICE [n]
SAKTI	(Hindu) the wife of a god in Hinduism [n -S]
SAKTIS	SAKTI, (Hindu) the wife of a god in Hinduism [n]
SAL	a large North Indian tree [n -S]
SALS	SAL, a large North Indian tree [n]
SALWAR	(Urdu) a long tunic worn over a pair of baggy trousers, worn by women in Pakistan [n -S]
SALWARS	SALWAR, (Urdu) a long tunic worn over a pair of baggy trousers, worn by women in Pakistan [n]
SAMADHI	(Sanskrit) a state of oneness with the infinite [n -S]
SAMADHIS	SAMADHI, (Sanskrit) a state of oneness with the infinite [n]
SAMAJ	(Hindi) an official association [n -ES]
SAMAJES	SAMAJ, (Hindi) an official association [n]
SAMBAR	(Hindi) a large Asian deer, also SAMBHAR, SAMBHUR, SAMBUR [n -S]
SAMBARS	SAMBAR, (Hindi) a large Asian deer, also SAMBHAR, SAMBHUR, SAMBUR [n]
SAMBHAR	(Hindi) a large Asian deer, also SAMBAR, SAMBHUR, SAMBUR [n -S]
SAMBHARS	SAMBHAR, (Hindi) a large Asian deer, also SAMBAR, SAMBHUR, SAMBUR [n]
SAMBHUR	(Hindi) a large Asian deer, also SAMBAR, SAMBHAR, SAMBUR [n -S]
SAMBHURS	SAMBHUR, (Hindi) a large Asian deer, also SAMBAR, SAMBHAR, SAMBUR [n]
SAMBUR	(Hindi) a large Asian deer, also SAMBAR, SAMBHAR, SAMBHUR [n -S]
SAMBURS	SAMBUR, (Hindi) a large Asian deer, also SAMBAR, SAMBHAR, SAMBHUR [n]
SAMITHI	(Hindi) a political organization, also SAMITI [n -S]
SAMITHIS	SAMITHI, (Hindi) a political organization, also SAMITI [n]
SAMITI	(Hindi) a political organization, also SAMITHI [n -S]
SAMITIS	SAMITI, (Hindi) a political organization, also SAMITHI [n]
SAMMIES	SAMMY, (South African) an Indian fruit and vegetable seller who goes from house to house [n]
SAMMY	(South African) an Indian fruit and vegetable seller who goes from house to house [n SAMMIES]
SAMOSA	(Hindi) a small, fried pastry turnover stuffed with spiced vegetables [n -S]
SAMOSAS	SAMOSA, (Hindi) a small, fried pastry turnover stuffed with spiced vegetables [n]
SAMSARA	(Sanskrit) the never-ending cycle of birth, death and rebirth [n -S]
SAMSARAS	SAMSARA, (Sanskrit) the never-ending cycle of birth, death and rebirth [n]
SAMSKARA	(Sanskrit) a Hindu purification ceremony [n -S]
SAMSKARAS	SAMSKARA, (Sanskrit) a Hindu purification ceremony [n]
SANDALWOOD	a compact and fine-grained very fragrant East Indian wood; the parasitic tree yielding it [n -S]
SANDALWOODS	SANDALWOOD, a compact and fine-grained very fragrant East Indian wood; the parasitic tree yielding it [n]
SANDHI	(Sanskrit) the modification of a sound of a word by its context, e.g. the difference in pronunciation of 'the' in 'the house' and in 'the other house' [n -S]
SANDHIS	SANDHI, (Sanskrit) the modification of a sound of a word by its context, e.g. the difference in pronunciation of 'the' in 'the house' and in 'the other house' [n]
SANGAT	(Sanskrit) a fellowship or assembly, also SANGHA, SANGHAT [n -S]
SANGATS	SANGAT, (Sanskrit) a fellowship or assembly, also SANGHA, SANGHAT [n]
SANGEET	(Hindi) a kind of pre-wedding party in a Hindi or Sikh marriage [n -S]
SANGEETS	SANGEET, (Hindi) a kind of pre-wedding party in a Hindi or Sikh marriage [n]
SANGH	(Hindi) an association promoting unity between different groups in Hinduism [n -S]
SANGHA	(Sanskrit) a fellowship or assembly, also SANGAT, SANGHAT [n -S]
SANGHAS	SANGHA, (Sanskrit) a fellowship or assembly, also SANGAT, SANGHAT [n]
SANGHAT	(Sanskrit) a fellowship or assembly, also SANGAT, SANGHA [n -S]
SANGHATS	SANGHAT, (Sanskrit) a fellowship or assembly, also SANGAT, SANGHA [n]
SANGHS	SANGH, (Hindi) an association promoting unity between different groups in Hinduism [n]
SANNYASI	(Hindi) a Hindu ascetic or hermit who lives by begging, also SANNYASIN, SANYASI [n -S]
SANNYASIN	(Hindi) a Hindu ascetic or hermit who lives by begging, also SANNYASI, SANYASI [n -S]
SANNYASINS	SANNYASIN, (Hindi) a Hindu ascetic or hermit who lives by begging, also SANNYASI, SANYASI [n]
SANNYASIS	SANNYASI, (Hindi) a Hindu ascetic or hermit who lives by begging, also SANNYASIN, SANYASI [n]
SANT	(Hindi) in Sikhism, a devout person, a saint [n -S]
SANTS	SANT, (Hindi) in Sikhism, a devout person, a saint [n]
SANYASI	(Hindi) a Hindu ascetic or hermit who lives by begging, also SANNYASI, SANNYASIN [n -S]
SANYASIS	SANYASI, (Hindi) a Hindu ascetic or hermit who lives by begging, also SANNYASI, SANNYASIN [n]
SARANGI	(Hindi) an Indian stringed instrument, played like a fiddle [n -S]
SARANGIS	SARANGI, (Hindi) an Indian stringed instrument, played like a fiddle [n]
SARDAR	(Urdu) a native chief in Hindostan; a headman, also SIRDAR [n -S]
SARDARS	SARDAR, (Urdu) a native chief in Hindostan; a headman, also SIRDAR [n]
SAREE	(Hindi) an outer garment worn by Hindu women, also SARI [n -S]
SAREES	SAREE, (Hindi) an outer garment worn by Hindu women, also SARI [n]
SARI	(Hindi) an outer garment worn by Hindu women, also SAREE [n -S]
SARIS	SARI, (Hindi) an outer garment worn by Hindu women, also SAREE [n]
SAROD	(Hindi) an Indian instrument like a cello, also SARODE [n -S]
SARODE	(Hindi) an Indian instrument like a cello, also SAROD [n -S]
SARODES	SARODE, (Hindi) an Indian instrument like a cello, also SAROD [n]
SARODIST	one who plays the sarod, an Indian instrument like a cello [n -S]
SARODISTS	SARODIST, one who plays the sarod, an Indian instrument like a cello [n]
SARODS	SAROD, (Hindi) an Indian instrument like a cello, also SARODE [n]
SARPANCH	(Hindi) the head of an Indian village [n -ES]
SARPANCHES	SARPANCH, (Hindi) the head of an Indian village [n]
SARUS	(Hindi) a large redheaded crane found from India to the Philippines [n -ES]
SARUSES	SARUS, (Hindi) a large redheaded crane found from India to the Philippines [n]
SASIN	(Nepali) the common Indian antelope [n -S]
SASINS	SASIN, (Nepali) the common Indian antelope [n]
SASTRA	(Sanskrit) any of the sacred writings of Hinduism, also SHASTER, SHASTRA [n -S]
SASTRAS	SASTRA, (Sanskrit) any of the sacred writings of Hinduism, also SHASTER, SHASTRA [n]
SATARA	(Hindi) a ribbed lustred wool [n -S]
SATARAS	SATARA, (Hindi) a ribbed lustred wool [n]
SATI	(Sanskrit) the act of a Hindu widow willingly being cremated on the funeral pyre of her husband, also SUTTEE [n -S]
SATINWOOD	a smooth, satiny ornamental wood from India [n -S]
SATINWOODS	SATINWOOD, a smooth, satiny ornamental wood from India [n]
SATIS	SATI, (Sanskrit) the act of a Hindu widow willingly being cremated on the funeral pyre of her husband, also SUTTEE [n]
SATSANG	(Sanskrit) a sacred gathering in Hinduism [n -S]
SATSANGS	SATSANG, (Sanskrit) a sacred gathering in Hinduism [n]
SATYAGRAHA	(Sanskrit) the policy of passive resistance inaugurated by Mohandas Gandhi in 1919 as a method of gaining political and social reforms [n -S]
SATYAGRAHAS	SATYAGRAHA, (Sanskrit) the policy of passive resistance inaugurated by Mohandas Gandhi in 1919 as a method of gaining political and social reforms [n]
SATYAGRAHI	(Sanskrit) an exponent of satyagraha, passive resistance, esp. as a form of political protest [n -S]
SATYAGRAHIS	SATYAGRAHI, (Sanskrit) an exponent of satyagraha, passive resistance, esp. as a form of political protest [n]
SAVARI	(Hindi) a passenger [n -S]
SAVARIS	SAVARI, (Hindi) a passenger [n]
SCITAMINEOUS	of the Scitamineae, an order of monocotyledons including the banana, ginger, Indian shot, and arrowroot families [adj]
SEBUNDIES	SEBUNDY, (Urdu) an Indian irregular soldier [n]
SEBUNDY	(Urdu) an Indian irregular soldier [n SEBUNDIES]
SECTARIAL	distinguishing a sect, esp. in India [adj]
SEIR	(Portuguese) a fish of the mackerel family, found in the eastern coastal waters of India [n -S]
SEIRS	SEIR, (Portuguese) a fish of the mackerel family, found in the eastern coastal waters of India [n]
SEMSEM	(Arabic) an East Indian plant, also SESAME, TEEL [n -S]
SEMSEMS	SEMSEM, (Arabic) an East Indian plant, also SESAME, TEEL [n]
SENA	(Hindi) in India, an army, esp. used of paramilitary organisations representing various castes [n -S]
SENAS	SENA, (Hindi) in India, an army, esp. used of paramilitary organisations representing various castes [n]
SEPHEN	(Arabic) a large stingray of the Indian Ocean and the Red Sea [n -S]
SEPHENS	SEPHEN, (Arabic) a large stingray of the Indian Ocean and the Red Sea [n]
SEPOY	(historical) an Indian soldier [n -S]
SEPOYS	SEPOY, (historical) an Indian soldier [n]
SER	an Indian unit of weight [n -S]
SERANG	(Urdu) the boatswain of a Lascar or East Indian crew [n -S]
SERANGS	SERANG, (Urdu) the boatswain of a Lascar or East Indian crew [n]
SEROW	a Himalayan goatlike antelope, aka thar [n -S]
SEROWS	SEROW, a Himalayan goatlike antelope, aka thar [n]
SERS	SER, an Indian unit of weight [n]
SEV	(Hindi) an Indian food of deep-fried strands of flour [n -S]
SEVS	SEV, (Hindi) an Indian food of deep-fried strands of flour [n]
SHABASH	(Hinglish) bravo or well done [interj]
SHALWAR	(Urdu) loose-fitting trousers worn by both sexes in many parts of Asia [n -S]
SHALWARS	SHALWAR, (Urdu) loose-fitting trousers worn by both sexes in many parts of Asia [n]
SHAMA	(Hindi) an Indian millet-like cereal; an Indian songbird [n -S]
SHAMAS	SHAMA, (Hindi) an Indian millet-like cereal; an Indian songbird [n]
SHAMIANA	(Hindi) in India, a large tent, awning or canopy, also SHAMIANAH, SHAMIYANAH [n -S]
SHAMIANAH	(Hindi) in India, a large tent, awning or canopy, also SHAMIANA, SHAMIYANAH [n -S]
SHAMIANAHS	SHAMIANAH, (Hindi) in India, a large tent, awning or canopy, also SHAMIANA, SHAMIYANAH [n]
SHAMIANAS	SHAMIANA, (Hindi) in India, a large tent, awning or canopy, also SHAMIANAH, SHAMIYANAH [n]
SHAMIYANAH	(Hindi) in India, a large tent or awning, also SHAMIANA, SHAMIANAH [n -S]
SHAMIYANAHS	SHAMIYANAH, (Hindi) in India, a large tent or awning, also SHAMIANA, SHAMIANAH [n]
SHANTI	(Sanskrit) peace, also SHANTIH [n -S]
SHANTIH	(Sanskrit) peace, also SHANTI [n -S]
SHANTIHS	SHANTIH, (Sanskrit) peace, also SHANTI [n]
SHANTIS	SHANTI, (Sanskrit) peace, also SHANTIH [n]
SHASTER	(Sanskrit) any of the sacred writings of Hinduism, also SASTRA, SHASTRA [n -S]
SHASTERS	SHASTER, (Sanskrit) any of the sacred writings of Hinduism, also SASTRA, SHASTRA [n]
SHASTRA	(Sanskrit) any of the sacred writings of Hinduism, also SASTRA, SHASTER [n -S]
SHASTRAS	SHASTRA, (Sanskrit) any of the sacred writings of Hinduism, also SASTRA, SHASTER [n]
SHAYA	(Tamil) an Indian plant of the madder family whose root chayroot yields a red dye, also CHAY, CHAYA [n -S]
SHAYAS	SHAYA, (Tamil) an Indian plant of the madder family whose root chayroot yields a red dye, also CHAY, CHAYA [n]
SHEESHA	(Urdu) a kind of water-pipe for smoking, aka hookah, also SHISHA [n -S]
SHEESHAS	SHEESHA, (Urdu) a kind of water-pipe for smoking, aka hookah, also SHISHA [n]
SHEHNAI	(Bengali) a double-reed wind instrument of India, also SHENAI [n -S]
SHEHNAIS	SHEHNAI, (Bengali) a double-reed wind instrument of India, also SHENAI [n]
SHENAI	(Bengali) a double-reed wind instrument of India, also SHEHNAI [n -S]
SHENAIS	SHENAI, (Bengali) a double-reed wind instrument of India, also SHEHNAI [n]
SHEROOT	(Tamil) a square-cut cigar, also CHEROOT [n -S]
SHEROOTS	SHEROOT, (Tamil) a square-cut cigar, also CHEROOT [n]
SHERWANI	(Hindi) in India, a man's knee-length coat buttoning up to the chin [n -S]
SHERWANIS	SHERWANI, (Hindi) in India, a man's knee-length coat buttoning up to the chin [n]
SHIKAR	(Urdu) to hunt (animal) as sport [v SHIKARRED, SHIKARRING, SHIKARS]
SHIKARA	(Hindi) a light, flat-bottomed boat in Kashmir [n -S]
SHIKARAS	SHIKARA, (Hindi) a light, flat-bottomed boat in Kashmir [n]
SHIKAREE	(Urdu) a hunter, esp. of big game, also SHIKARI [n -S]
SHIKAREES	SHIKAREE, (Urdu) a hunter, esp. of big game, also SHIKARI [n]
SHIKARI	(Urdu) a hunter, esp. of big game, also SHIKAREE [n -S]
SHIKARIS	SHIKARI, (Urdu) a hunter, esp. of big game, also SHIKAREE [n]
SHIKARRED	SHIKAR, (Urdu) to hunt (animal) as sport [v]
SHIKARRING	SHIKAR, (Urdu) to hunt (animal) as sport [v]
SHIKARS	SHIKAR, (Urdu) to hunt (animal) as sport [v]
SHIKRA	(Hindi) a small sparrow hawk [n -S]
SHIKRAS	SHIKRA, (Hindi) a small sparrow hawk [n]
SHISHA	(Urdu) a kind of water-pipe for smoking, aka hookah, also SHEESHA [n -S]
SHISHAS	SHISHA, (Urdu) a kind of water-pipe for smoking, aka hookah, also SHEESHA [n]
SHOLA	(Hindi) an Indian plant with a pith used in making tropical hats, aka spongewood, also SOLA, SOLAH [n -S]
SHOLAS	SHOLA, (Hindi) an Indian plant with a pith used in making tropical hats, aka spongewood, also SOLA, SOLAH [n]
SHRADDHA	(Sanskrit) an offering to the manes of an ancestor, also SRADDHA, SRADHA [n -S]
SHRADDHAS	SHRADDHA, (Sanskrit) an offering to the manes of an ancestor, also SRADDHA, SRADHA [n]
SHRI	(Sanskrit) in India, a title of great respect given to a man, also SRI [n -S]
SHRIS	SHRI, (Sanskrit) in India, a title of great respect given to a man, also SRI [n]
SICE	(Arabic) a stableman or groom, esp. in India, also SAICE, SYCE [n -S]
SICES	SICE, (Arabic) a stableman or groom, esp. in India, also SAICE, SYCE [n]
SIDDHA	(Sanskrit) one who has attained occult power or siddhi, also SIDHA [n -S]
SIDDHAS	SIDDHA, (Sanskrit) one who has attained occult power or siddhi, also SIDHA [n]
SIDDHI	(Sanskrit) in Buddhism, the supernatural powers that come with meditation [n -S]
SIDDHIS	SIDDHI, (Sanskrit) in Buddhism, the supernatural powers that come with meditation [n]
SIDDHUISM	(Hinglish) any contrived metaphor or simile, also SIDHUISM [n -S]
SIDDHUISMS	SIDDHUISM, (Hinglish) any contrived metaphor or simile, also SIDHUISM [n]
SIDHA	(Sanskrit) one who has attained occult powers or siddhi, also SIDDHA [n -S]
SIDHAS	SIDHA, (Sanskrit) one who has attained occult powers or siddhi, also SIDDHA [n]
SIDHUISM	(Hinglish) any contrived metaphor or simile, also SIDDHUISM [n -S]
SIDHUISMS	SIDHUISM, (Hinglish) any contrived metaphor or simile, also SIDDHUISM [n]
SILLADAR	(Urdu) an irregular cavalryman who provided his own horse and arms [n -S]
SILLADARS	SILLADAR, (Urdu) an irregular cavalryman who provided his own horse and arms [n]
SIRCAR	(Urdu) the state or government; the authorities, also CIRCAR, SIRKAR [n -S]
SIRCARS	SIRCAR, (Urdu) the state or government; the authorities, also CIRCAR, SIRKAR [n]
SIRDAR	(Urdu) a native chief in Hindostan; a headman, also SARDAR [n -S]
SIRDARS	SIRDAR, (Urdu) a native chief in Hindostan; a headman, also SARDAR [n]
SIRKAR	(Urdu) the state or government; the authorities, also CIRCAR, SIRCAR [n -S]
SIRKARS	SIRKAR, (Urdu) the state or government; the authorities, also CIRCAR, SIRCAR [n]
SISSOO	(Hindi) an Indian timber tree [n -S]
SISSOOS	SISSOO, (Hindi) an Indian timber tree [n]
SITAR	(Urdu) an Indian musical instrument, also SITTAR [n -S]
SITARS	SITAR, (Urdu) an Indian musical instrument, also SITTAR [n]
SITTAR	(Urdu) an Indian musical instrument, also SITAR [n -S]
SITTARS	SITTAR, (Urdu) an Indian musical instrument, also SITAR [n]
SMRITI	(Sanskrit) a class of Hindu sacred literature [n -S]
SMRITIS	SMRITI, (Sanskrit) a class of Hindu sacred literature [n]
SNAKEWOOD	an East Indian climbing plant having a bitter taste, and supposed to be a remedy for the bite of the cobra [n -S]
SNAKEWOODS	SNAKEWOOD, an East Indian climbing plant having a bitter taste, and supposed to be a remedy for the bite of the cobra [n]
SNOWSNAKE	an Indian game in which a straight wooden rod having a weighted head like that of a snake is slid over a smooth field of snow or down specially constructed runways [n -S]
SNOWSNAKES	SNOWSNAKE, an Indian game in which a straight wooden rod having a weighted head like that of a snake is slid over a smooth field of snow or down specially constructed runways [n]
SOLA	(Hindi) an Indian plant with a pith used in making tropical hats, aka spongewood, also SHOLA, SOLAH [n -S]
SOLAH	(Hindi) an Indian plant with a pith used in making tropical hats, aka spongewood, also SHOLA, SOLA [n -S]
SOLAHS	SOLAH, (Hindi) an Indian plant with a pith used in making tropical hats, aka spongewood, also SHOLA, SOLA [n]
SOLAS	SOLA, (Hindi) an Indian plant with a pith used in making tropical hats, aka spongewood, also SHOLA, SOLAH [n]
SONDELI	the Indian musk shrew [n -S]
SONDELIS	SONDELI, the Indian musk shrew [n]
SONERI	(Hindi) a cloth of gold [n -S]
SONERIS	SONERI, (Hindi) a cloth of gold [n]
SOUCAR	(Hindi) a Hindu banker, also SOWCAR [n -S]
SOUCARS	SOUCAR, (Hindi) a Hindu banker, also SOWCAR [n]
SOWAR	(Urdu) a mounted native soldier in India [n -S]
SOWARREE	(Urdu) a mounted retinue, a cavalcade, also SOWARRY [n -S]
SOWARREES	SOWARREE, (Urdu) a mounted retinue, a cavalcade, also SOWARRY [n]
SOWARRIES	SOWARRY, (Urdu) a mounted retinue, a cavalcade, also SOWARREE [n]
SOWARRY	(Urdu) a mounted retinue, a cavalcade, also SOWARREE [n SOWARRIES]
SOWARS	SOWAR, (Urdu) a mounted native soldier in India [n]
SOWCAR	(Hindi) a Hindu banker, also SOUCAR [n -S]
SOWCARS	SOWCAR, (Hindi) a Hindu banker, also SOUCAR [n]
SPIKENARD	an aromatic oil or balsam yielded by an Indian valerianaceous herb [n -S]
SPIKENARDS	SPIKENARD, an aromatic oil or balsam yielded by an Indian valerianaceous herb [n]
SPONGEWOOD	an Indian plant with a pith used in making tropical hats, aka sola [n -S]
SPONGEWOODS	SPONGEWOOD, an Indian plant with a pith used in making tropical hats, aka sola [n]
SRADDHA	(Sanskrit) an offering to the manes of an ancestor, also SHRADDHA, SRADHA [n -S]
SRADDHAS	SRADDHA, (Sanskrit) an offering to the manes of an ancestor, also SHRADDHA, SRADHA [n]
SRADHA	(Sanskrit) an offering to the manes of an ancestor, also SHRADDHA, SRADDHA [n -S]
SRADHAS	SRADHA, (Sanskrit) an offering to the manes of an ancestor, also SHRADDHA, SRADDHA [n]
SRI	(Sanskrit) in India, a title of great respect given to a man, also SHRI [n -S]
SRIS	SRI, (Sanskrit) in India, a title of great respect given to a man, also SHRI [n]
SRUTI	(Sanskrit) a class of Hindu sacred literature [n -S]
SRUTIS	SRUTI, (Sanskrit) a class of Hindu sacred literature [n]
STUPA	(Sanskrit) a mound or monument commemorative of Buddha [n -S]
STUPAS	STUPA, (Sanskrit) a mound or monument commemorative of Buddha [n]
SUBA	(Hindi) a province of the Mogul empire, also SUBAH [n -S]
SUBADAR	(Hindi) a native officer in an Indian regiment corresponding to a captain, also SUBAHDAR, SUBEDAR [n -S]
SUBADARS	SUBADAR, (Hindi) a native officer in an Indian regiment corresponding to a captain, also SUBAHDAR, SUBEDAR [n]
SUBAH	(Hindi) a province of the Mogul empire, also SUBA [n -S]
SUBAHDAR	(Hindi) a native officer in an Indian regiment corresponding to a captain, also SUBADAR, SUBEDAR [n -S]
SUBAHDARS	SUBAHDAR, (Hindi) a native officer in an Indian regiment corresponding to a captain, also SUBADAR, SUBEDAR [n]
SUBAHS	SUBAH, (Hindi) a province of the Mogul empire, also SUBA [n]
SUBAS	SUBA, (Hindi) a province of the Mogul empire, also SUBAH [n]
SUBEDAR	(Hindi) a native officer in an Indian regiment corresponding to a captain, also SUBADAR, SUBAHDAR [n -S]
SUBEDARS	SUBEDAR, (Hindi) a native officer in an Indian regiment corresponding to a captain, also SUBADAR, SUBAHDAR [n]
SUNDARI	(Sanskrit) an East Indian tree, also SUNDRA, SUNDRI [n -S]
SUNDARIS	SUNDARI, (Sanskrit) an East Indian tree, also SUNDRA, SUNDRI [n]
SUNDRA	(Sanskrit) a timber tree, also SUNDARI, SUNDRI [n -S]
SUNDRAS	SUNDRA, (Sanskrit) a timber tree, also SUNDARI, SUNDRI [n]
SUNDRI	(Sanskrit) an East Indian tree, also SUNDARI, SUNDRA [n -S]
SUNDRIS	SUNDRI, (Sanskrit) an East Indian tree, also SUNDARI, SUNDRA [n]
SUNN	(Hindi) an East Indian plant with tough fibre used in cordage [n -S]
SUNNS	SUNN, (Hindi) an East Indian plant with tough fibre used in cordage [n]
SUPERBAZAAR	in India, a large department store or supermarket, esp. one set up as a cooperative store by the government, also SUPERBAZAR [n -S]
SUPERBAZAARS	SUPERBAZAAR, in India, a large department store or supermarket, esp. one set up as a cooperative store by the government, also SUPERBAZAR [n]
SUPERBAZAR	in India, a large department store or supermarket, esp. one set up as a cooperative store by the government, also SUPERBAZAAR [n -S]
SUPERBAZARS	SUPERBAZAR, in India, a large department store or supermarket, esp. one set up as a cooperative store by the government, also SUPERBAZAAR [n]
SURAT	(Hindi) a coarse uncoloured cotton [n -S]
SURATS	SURAT, (Hindi) a coarse uncoloured cotton [n]
SURBAHAR	(Bengali) an Indian stringed instrument, larger than a sitar [n -S]
SURBAHARS	SURBAHAR, (Bengali) an Indian stringed instrument, larger than a sitar [n]
SURRA	(Marathi) a trypanosome disease of the blood in horses [n -S]
SURRAS	SURRA, (Marathi) a trypanosome disease of the blood in horses [n]
SUTRA	(Sanskrit) a precept; an aphorism; a brief rule, also SUTTA [n -S]
SUTRAS	SUTRA, (Sanskrit) a precept; an aphorism; a brief rule, also SUTTA [n]
SUTTEE	(Sanskrit) the act of a Hindu widow willingly being cremated on the funeral pyre of her husband, also SATI [n -S]
SUTTEEISM	the Indian practice of self-immolation of widows [n -S]
SUTTEEISMS	SUTTEEISM, the Indian practice of self-immolation of widows [n]
SUTTEES	SUTTEE, (Sanskrit) the act of a Hindu widow willingly being cremated on the funeral pyre of her husband, also SATI [n]
SVARABHAKTI	(Sanskrit) the development of a vowel between consonants [n -S]
SVARABHAKTIS	SVARABHAKTI, (Sanskrit) the development of a vowel between consonants [n]
SVARAJ	(Sanskrit) self-government, home rule, also SWARAJ [n -ES]
SVARAJES	SVARAJ, (Sanskrit) self-government, home rule, also SWARAJ [n]
SVASTIKA	(Sanskrit) a Greek cross with arms bent at a right angle, also SWASTICA, SWASTIKA [n -S]
SVASTIKAS	SVASTIKA, (Sanskrit) a Greek cross with arms bent at a right angle, also SWASTICA, SWASTIKA [n]
SWACHH	(Hindi) clean [adj]
SWAMI	(Hindi) a Hindu mystic, also SWAMY [n -S]
SWAMIES	SWAMY, (Hindi) a Hindu mystic, also SWAMI [n]
SWAMIS	SWAMI, (Hindi) a Hindu mystic, also SWAMY [n]
SWAMY	(Hindi) a Hindu mystic, also SWAMI [n SWAMIES]
SWARAJ	(Sanskrit) self-government, home rule, also SVARAJ [n -ES]
SWARAJES	SWARAJ, (Sanskrit) self-government, home rule, also SVARAJ [n]
SWARAJISM	the policy of Indian political independence [n -S]
SWARAJISMS	SWARAJISM, the policy of Indian political independence [n]
SWARAJIST	one who adhered to swaraj, the policy of Indian political independence [n -S]
SWARAJISTS	SWARAJIST, one who adhered to swaraj, the policy of Indian political independence [n]
SWASTICA	(Sanskrit) a Greek cross with arms bent at a right angle, also SVASTIKA, SWASTIKA [n -S]
SWASTICAS	SWASTICA, (Sanskrit) a Greek cross with arms bent at a right angle, also SVASTIKA, SWASTIKA [n]
SWASTIKA	(Sanskrit) a Greek cross with arms bent at a right angle, also SVASTIKA, SWASTICA [n -S]
SWASTIKAS	SWASTIKA, (Sanskrit) a Greek cross with arms bent at a right angle, also SVASTIKA, SWASTICA [n]
SYCE	(Arabic) a male servant in India, also SAICE, SICE [n -S]
SYCES	SYCE, (Arabic) a male servant in India, also SAICE, SICE [n]
TABASHEER	(Hindi) a siliceous substance sometimes found in crude form in hollows of bamboos, used in Eastern medicine, also TABASHIR [n -S]
TABASHEERS	TABASHEER, (Hindi) a siliceous substance sometimes found in crude form in hollows of bamboos, used in Eastern medicine, also TABASHIR [n]
TABLA	(Hindi) an Indian percussion instrument, a pair of small drums [n -S]
TABLAS	TABLA, (Hindi) an Indian percussion instrument, a pair of small drums [n]
TAHR	a Himalayan wild goat, also TEHR [n -S]
TAHRS	TAHR, a Himalayan wild goat, also TEHR [n]
TAHSIL	(Urdu) in India, a division of a district for revenue and certain other purposes, also TEHSIL [n -S]
TAHSILDAR	an Indian district official in charge of revenues [n -S]
TAHSILDARS	TAHSILDAR, an Indian district official in charge of revenues [n]
TAHSILS	TAHSIL, (Urdu) in India, a division of a district for revenue and certain other purposes, also TEHSIL [n]
TAKA	(Bengali) a monetary unit of Bangladesh [n -S]
TAKAS	TAKA, (Bengali) a monetary unit of Bangladesh [n]
TALA	(Sanskrit) a traditional rhythmic pattern in Indian music [n -S]
TALAS	TALA, (Sanskrit) a traditional rhythmic pattern in Indian music [n]
TALIPAT	(Sinhalese) a very tall southern Indian fan palm with enormous leaves which are used as sunshades etc., also TALIPOT [n -S]
TALIPATS	TALIPAT, (Sinhalese) a very tall southern Indian fan palm with enormous leaves which are used as sunshades etc., also TALIPOT [n]
TALIPOT	(Sinhalese) a very tall southern Indian fan palm with enormous leaves which are used as sunshades etc., also TALIPAT [n -S]
TALIPOTS	TALIPOT, (Sinhalese) a very tall southern Indian fan palm with enormous leaves which are used as sunshades etc., also TALIPAT [n]
TALOOKA	(Hindi) an estate in India, also TALUK, TALUKA [n -S]
TALOOKAS	TALOOKA, (Hindi) an estate in India, also TALUK, TALUKA [n]
TALUK	(Hindi) a large estate, a revenue district, also TALOOKA, TALUKA [n -S]
TALUKA	(Hindi) an estate in India, also TALUK, TALOOKA [n -S]
TALUKAS	TALUKA, (Hindi) an estate in India, also TALUK, TALOOKA [n]
TALUKDAR	(Hindi) a proprietor of a taluk, a large estate [n -S]
TALUKDARS	TALUKDAR, (Hindi) a proprietor of a taluk, a large estate [n]
TALUKS	TALUK, (Hindi) a large estate, a revenue district, also TALOOKA, TALUKA [n]
TAMANU	(Tahitian) an East Indian tree, yielding tacamahac, a kind of gum resin [n -S]
TAMANUS	TAMANU, (Tahitian) an East Indian tree, yielding tacamahac, a kind of gum resin [n]
TAMASHA	(Urdu) in the Indian subcontinent, an entertainment, a show, a public function [n -S]
TAMASHAS	TAMASHA, (Urdu) in the Indian subcontinent, an entertainment, a show, a public function [n]
TANA	(Hindi) an Indian police station, also TANNA, TANNAH, THANA, THANAH, THANNA, THANNAH [n -S]
TANADAR	(Hindi) an officer in charge of a tana, a police station, also THANADAR [n -S]
TANADARS	TANADAR, (Hindi) an officer in charge of a tana, a police station, also THANADAR [n]
TANAS	TANA, (Hindi) an Indian police station, also TANNA, TANNAH, THANA, THANAH, THANNA, THANNAH [n]
TANDOOR	(Hindi) a type of Indian cooking in which meat, vegetables etc. are baked over charcoal in a clay oven, also TANDOORI [n -S]
TANDOORI	(Hindi) a type of Indian cooking in which meat, vegetables etc. are baked over charcoal in a clay oven, also TANDOOR [n -S]
TANDOORIS	TANDOORI, (Hindi) a type of Indian cooking in which meat, vegetables etc. are baked over charcoal in a clay oven, also TANDOOR [n]
TANDOORS	TANDOOR, (Hindi) a type of Indian cooking in which meat, vegetables etc. are baked over charcoal in a clay oven, also TANDOORI [n]
TANGUN	(Hindi) a piebald variety of the horse, native of Tibet [n -S]
TANGUNS	TANGUN, (Hindi) a piebald variety of the horse, native of Tibet [n]
TANNA	(Hindi) an Indian police station, also TANA, TANNAH, THANA, THANAH, THANNA, THANNAH [n -S]
TANNAH	(Hindi) an Indian police station, also TANA, TANNA, THANA, THANAH, THANNA, THANNAH [n -S]
TANNAHS	TANNAH, (Hindi) an Indian police station, also TANA, TANNA, THANA, THANAH, THANNA, THANNAH [n]
TANNAS	TANNA, (Hindi) an Indian police station, also TANA, TANNAH, THANA, THANAH, THANNA, THANNAH [n]
TANTRA	(Sanskrit) a class of Hindu religious writings [n -S]
TANTRAS	TANTRA, (Sanskrit) a class of Hindu religious writings [n]
TANTRISM	a school of Buddhism incorporating Hindu and pagan elements [n -S]
TANTRISMS	TANTRISM, a school of Buddhism incorporating Hindu and pagan elements [n]
TASAR	(Hindi) a fawn-coloured silk made from wild Indian silkworms, also TUSSAH, TUSSAR, TUSSEH, TUSSER, TUSSOR, TUSSORE, TUSSUR [n -S]
TASARS	TASAR, (Hindi) a fawn-coloured silk made from wild Indian silkworms, also TUSSAH, TUSSAR, TUSSEH, TUSSER, TUSSOR, TUSSORE, TUSSUR [n]
TASSA	(Hindi) a large Indian kettledrum, worn hanging round the neck [n -S]
TASSAS	TASSA, (Hindi) a large Indian kettledrum, worn hanging round the neck [n]
TATHATA	(Sanskrit) the ultimate nature of things in Buddhism [n -S]
TATHATAS	TATHATA, (Sanskrit) the ultimate nature of things in Buddhism [n]
TATPURUSHA	(Sanskrit) a class of compound words in which the first element modifies the second by standing to it in various types of relation e.g. goatskin, fieldmouse [n -S]
TATPURUSHAS	TATPURUSHA, (Sanskrit) a class of compound words in which the first element modifies the second by standing to it in various types of relation e.g. goatskin, fieldmouse [n]
TAVA	(Hindi) a griddle in Indian cookery, also TAVAH, TAWA [n -S]
TAVAH	(Hindi) a griddle in Indian cookery, also TAVA, TAWA [n -S]
TAVAHS	TAVAH, (Hindi) a griddle in Indian cookery, also TAVA, TAWA [n]
TAVAS	TAVA, (Hindi) a griddle in Indian cookery, also TAVAH, TAWA [n]
TAWA	(Hindi) a griddle in Indian cookery, also TAVA, TAVAH [n -S]
TAWAS	TAWA, (Hindi) a griddle in Indian cookery, also TAVA, TAVAH [n]
TEAPOY	(Hindi) an ornamental stand, usually with three legs, having caddies for holding tea, also TEPOY [n -S]
TEAPOYS	TEAPOY, (Hindi) an ornamental stand, usually with three legs, having caddies for holding tea, also TEPOY [n]
TEEK	(Hinglish) well [adj]
TEHR	a Himalayan wild goat, also TAHR [n -S]
TEHRS	TEHR, a Himalayan wild goat, also TAHR [n]
TEHSIL	(Hindi) in India, a division of a district for revenue and certain other purposes, also TAHSIL [n -S]
TEHSILDAR	(Hindi) one who administrates a tehsil [n -S]
TEHSILDARS	TEHSILDAR, (Hindi) one who administrates a tehsil [n]
TEHSILS	TEHSIL, (Hindi) in India, a division of a district for revenue and certain other purposes, also TAHSIL [n]
TEPOY	(Hindi) an ornamental stand, usually with three legs, having caddies for holding tea, also TEAPOY [n -S]
TEPOYS	TEPOY, (Hindi) an ornamental stand, usually with three legs, having caddies for holding tea, also TEAPOY [n]
TERAI	(Hindi) a wide-brimmed ventilated hat [n -S]
TERAIS	TERAI, (Hindi) a wide-brimmed ventilated hat [n]
THAGI	(Hindi) murder and robbery by thugs, also THUGGEE [n -S]
THAGIS	THAGI, (Hindi) murder and robbery by thugs, also THUGGEE [n]
THALI	(Hindi) a meal consisting of several small meat or vegetable dishes accompanied by rice, bread, etc., and sometimes by a starter or a sweet [n -S]
THALIS	THALI, (Hindi) a meal consisting of several small meat or vegetable dishes accompanied by rice, bread, etc., and sometimes by a starter or a sweet [n]
THANA	(Hindi) an Indian police station, also TANA, TANNA, TANNAH, THANAH, THANNA, THANNAH [n -S]
THANADAR	(Hindi) an officer in charge of a tana, a police station, also TANADAR [n -S]
THANADARS	THANADAR, (Hindi) an officer in charge of a tana, a police station, also TANADAR [n]
THANAH	(Hindi) an Indian police station, also TANA, TANNA, TANNAH, THANA, THANNA, THANNAH [n -S]
THANAHS	THANAH, (Hindi) an Indian police station, also TANA, TANNA, TANNAH, THANA, THANNA, THANNAH [n]
THANAS	THANA, (Hindi) an Indian police station, also TANA, TANNA, TANNAH, THANAH, THANNA, THANNAH [n]
THANNA	(Hindi) an Indian police station, also TANA, TANNA, TANNAH, THANA, THANAH, THANNAH [n -S]
THANNAH	(Hindi) an Indian police station, also TANA, TANNA, TANNAH, THANA, THANAH, THANNA [n -S]
THANNAHS	THANNAH, (Hindi) an Indian police station, also TANA, TANNA, TANNAH, THANA, THANAH, THANNA [n]
THANNAS	THANNA, (Hindi) an Indian police station, also TANA, TANNA, TANNAH, THANA, THANAH, THANNAH [n]
THAR	(Nepali) a Himalayan goatlike antelope, aka serow [n -S]
THARS	THAR, (Nepali) a Himalayan goatlike antelope, aka serow [n]
THUGGEE	(Hindi) murder and robbery by thugs, also THAGI [n -S]
THUGGEES	THUGGEE, (Hindi) murder and robbery by thugs, also THAGI [n]
THUGGISM	the practices of Indian thugs [n -S]
THUGGISMS	THUGGISM, the practices of Indian thugs [n]
TICCA	(Hindi) hired [adj]
TIKA	(Hindi) a red mark or pendant on the forehead of Hindu women, originally of religious significance but now also worn for ornament, also TILAK [n -S]
TIKAS	TIKA, (Hindi) a red mark or pendant on the forehead of Hindu women, originally of religious significance but now also worn for ornament, also TILAK [n]
TIKKA	(Hindi) a dish of meat or vegetables marinated in yoghurt and spices [n -S]
TIKKAS	TIKKA, (Hindi) a dish of meat or vegetables marinated in yoghurt and spices [n]
TILAK	(Hindi) a red mark or pendant on the forehead of Hindu women, originally of religious significance but now also worn for ornament, also TIKA [n -S]
TILAKS	TILAK, (Hindi) a red mark or pendant on the forehead of Hindu women, originally of religious significance but now also worn for ornament, also TIKA [n]
TINDAL	(Malayalam) a petty officer of lascars [n -S]
TINDALS	TINDAL, (Malayalam) a petty officer of lascars [n]
TODDIES	TODDY, (Hindi) the fermented sap of various palm trees [n]
TODDY	(Hindi) the fermented sap of various palm trees [n TODDIES]
TOLA	(Hindi) an Indian unit of weight [n -S]
TOLAS	TOLA, (Hindi) an Indian unit of weight [n]
TONGA	(Hindi) a light two-wheeled Indian vehicle [n -S]
TONGAS	TONGA, (Hindi) a light two-wheeled Indian vehicle [n]
TOON	(Hindi) an Indian tree of the mahogany family [n -S]
TOONS	TOON, (Hindi) an Indian tree of the mahogany family [n]
TOPEE	(Hindi) a tropical pith helmet, also TOPI [n -S]
TOPEES	TOPEE, (Hindi) a tropical pith helmet, also TOPI [n]
TOPI	(Hindi) a tropical pith helmet, also TOPEE [n -S]
TOPIS	TOPI, (Hindi) a tropical pith helmet, also TOPEE [n]
TORAN	(Hindi) in the Indian subcontinent, a sacred Buddhist gateway, also TORANA [n -S]
TORANA	(Hindi) in the Indian subcontinent, a sacred Buddhist gateway, also TORAN [n -S]
TORANAS	TORANA, (Hindi) in the Indian subcontinent, a sacred Buddhist gateway, also TORAN [n]
TORANS	TORAN, (Hindi) in the Indian subcontinent, a sacred Buddhist gateway, also TORANA [n]
TRIBAL	pertaining to a tribe [adj TRIBALLY] / a member of an aboriginal tribe of India [n -S]
TRIBALS	TRIBAL, a member of an aboriginal tribe of India [n]
TRISUL	(Sanskrit) the trident of Siva, also TRISULA [n -S]
TRISULA	(Sanskrit) the trident of Siva, also TRISUL [n -S]
TRISULAS	TRISULA, (Sanskrit) the trident of Siva, also TRISUL [n]
TRISULS	TRISUL, (Sanskrit) the trident of Siva, also TRISULA [n]
TULSI	(Hindi) a type of basil, a sacred plant in Hindu belief [n -S]
TULSIS	TULSI, (Hindi) a type of basil, a sacred plant in Hindu belief [n]
TULWAR	(Hindi) an Indian sabre [n -S]
TULWARS	TULWAR, (Hindi) an Indian sabre [n]
TURMERIC	a spice used in Indian cooking [n -S]
TURMERICS	TURMERIC, a spice used in Indian cooking [n]
TUSSAH	(Hindi) a fawn-coloured silk made from wild Indian silkworms, also TASAR, TUSSAR, TUSSEH, TUSSER, TUSSOR, TUSSORE, TUSSUR [n -S]
TUSSAHS	TUSSAH, (Hindi) a fawn-coloured silk made from wild Indian silkworms, also TASAR, TUSSAR, TUSSEH, TUSSER, TUSSOR, TUSSORE, TUSSUR [n]
TUSSAR	(Hindi) a fawn-coloured silk made from wild Indian silkworms, also TASAR, TUSSAH, TUSSEH, TUSSER, TUSSOR, TUSSORE, TUSSUR [n -S]
TUSSARS	TUSSAR, (Hindi) a fawn-coloured silk made from wild Indian silkworms, also TASAR, TUSSAH, TUSSEH, TUSSER, TUSSOR, TUSSORE, TUSSUR [n]
TUSSEH	(Hindi) a fawn-coloured silk made from wild Indian silkworms, also TASAR, TUSSAH, TUSSAR, TUSSER, TUSSOR, TUSSORE, TUSSUR [n -S]
TUSSEHS	TUSSEH, (Hindi) a fawn-coloured silk made from wild Indian silkworms, also TASAR, TUSSAH, TUSSAR, TUSSER, TUSSOR, TUSSORE, TUSSUR [n]
TUSSER	(Hindi) a fawn-coloured silk made from wild Indian silkworms, also TASAR, TUSSAH, TUSSAR, TUSSEH, TUSSOR, TUSSORE, TUSSUR [n -S]
TUSSERS	TUSSER, (Hindi) a fawn-coloured silk made from wild Indian silkworms, also TASAR, TUSSAH, TUSSAR, TUSSEH, TUSSOR, TUSSORE, TUSSUR [n]
TUSSOR	(Hindi) a fawn-coloured silk made from wild Indian silkworms, also TASAR, TUSSAH, TUSSAR, TUSSEH, TUSSER, TUSSORE, TUSSUR [n -S]
TUSSORE	(Hindi) a fawn-coloured silk made from wild Indian silkworms, also TASAR, TUSSAH, TUSSAR, TUSSEH, TUSSER, TUSSOR, TUSSUR [n -S]
TUSSORES	TUSSORE, (Hindi) a fawn-coloured silk made from wild Indian silkworms, also TASAR, TUSSAH, TUSSAR, TUSSEH, TUSSER, TUSSOR, TUSSUR [n]
TUSSORS	TUSSOR, (Hindi) a fawn-coloured silk made from wild Indian silkworms, also TASAR, TUSSAH, TUSSAR, TUSSEH, TUSSER, TUSSORE, TUSSUR [n]
TUSSUR	(Hindi) a fawn-coloured silk made from wild Indian silkworms, also TASAR, TUSSAH, TUSSAR, TUSSEH, TUSSER, TUSSOR, TUSSORE [n -S]
TUSSURS	TUSSUR, (Hindi) a fawn-coloured silk made from wild Indian silkworms, also TASAR, TUSSAH, TUSSAR, TUSSEH, TUSSER, TUSSOR, TUSSORE [n]
TUTENAG	(Marathi) an alloy of zinc, copper etc. [n -S]
TUTENAGS	TUTENAG, (Marathi) an alloy of zinc, copper etc. [n]
UNTOUCHABLE	not to be touched [adj] / one that is untouchable, esp. a Hindu of very low caste [n -S]
UNTOUCHABLES	UNTOUCHABLE, one that is untouchable, esp. a Hindu of very low caste [n]
URD	an annual bean grown in India [n -S]
URDS	URD, an annual bean grown in India [n]
URIAL	(Punjabi) a wild sheep of central Asia, that has a reddish coat and long curved horns, also OORIAL [n -S]
URIALS	URIAL, (Punjabi) a wild sheep of central Asia, that has a reddish coat and long curved horns, also OORIAL [n]
URVA	(Nepali) the crab-eating mongoose of SE Asia [n -S]
URVAS	URVA, (Nepali) the crab-eating mongoose of SE Asia [n]
VAHANA	(Sanskrit) a vehicle in Indian myth [n -S]
VAHANAS	VAHANA, (Sanskrit) a vehicle in Indian myth [n]
VAKEEL	(Hindi) a native lawyer in India, also VAKIL [n -S]
VAKEELS	VAKEEL, (Hindi) a native lawyer in India, also VAKIL [n]
VAKIL	(Hindi) a native lawyer in India, also VAKEEL [n -S]
VAKILS	VAKIL, (Hindi) a native lawyer in India, also VAKEEL [n]
VANASPATI	(Sanskrit) a hydrogenated vegetable fat used as a butter substitute [n -S]
VANASPATIS	VANASPATI, (Sanskrit) a hydrogenated vegetable fat used as a butter substitute [n]
VANDA	(Hindi) a kind of tropical orchid [n -S]
VANDAS	VANDA, (Hindi) a kind of tropical orchid [n]
VARNA	(Sanskrit) any of the four great Hindu castes [n -S]
VARNAS	VARNA, (Sanskrit) any of the four great Hindu castes [n]
VEENA	(Sanskrit) an Indian stringed instrument, also VINA [n -S]
VEENAS	VEENA, (Sanskrit) an Indian stringed instrument, also VINA [n]
VERANDA	(Hindi) a roofed gallery, terrace, or open portico along the front or side of a building, also VERANDAH, VIRANDA, VIRANDO [n -S]
VERANDAH	(Hindi) a roofed gallery, terrace, or open portico along the front or side of a building, also VERANDA, VIRANDA, VIRANDO [n -S]
VERANDAHS	VERANDAH, (Hindi) a roofed gallery, terrace, or open portico along the front or side of a building, also VERANDA, VIRANDA, VIRANDO [n]
VERANDAS	VERANDA, (Hindi) a roofed gallery, terrace, or open portico along the front or side of a building, also VERANDAH, VIRANDA, VIRANDO [n]
VETIVER	(Tamil) an East Indian grass; also, its fragrant roots which are much used for making mats and screens [n -S]
VETIVERS	VETIVER, (Tamil) an East Indian grass; also, its fragrant roots which are much used for making mats and screens [n]
VETIVERT	(Tamil) the essential oil of the vetiver, an East Indian grass [n -S]
VETIVERTS	VETIVERT, (Tamil) the essential oil of the vetiver, an East Indian grass [n]
VIHARA	(Sanskrit) a Buddhist or Jain temple or precinct [n -S]
VIHARAS	VIHARA, (Sanskrit) a Buddhist or Jain temple or precinct [n]
VIMANA	(Sanskrit) in the Indian subcontinent, the central tower enclosing the shrine in a temple [n -S]
VIMANAS	VIMANA, (Sanskrit) in the Indian subcontinent, the central tower enclosing the shrine in a temple [n]
VINA	(Sanskrit) an Indian stringed instrument, also VEENA [n -S]
VINAS	VINA, (Sanskrit) an Indian stringed instrument, also VEENA [n]
VIPASSANA	(Sanskrit) meditative practice in Buddhism, aimed at obtaining a true metaphysical picture of reality, which means dissolving the stable categories of substance and self in favour of the evanescent [n -S]
VIPASSANAS	VIPASSANA, (Sanskrit) meditative practice in Buddhism, aimed at obtaining a true metaphysical picture of reality, which means dissolving the stable categories of substance and self in favour of the evanescent [n]
VIRANDA	(Hindi) a roofed gallery, terrace, or open portico along the front or side of a building, also VERANDA, VERANDAH, VIRANDO [n -S]
VIRANDAS	VIRANDA, (Hindi) a roofed gallery, terrace, or open portico along the front or side of a building, also VERANDA, VERANDAH, VIRANDO [n]
VIRANDO	(Hindi) a roofed gallery, terrace, or open portico along the front or side of a building, also VERANDA, VERANDAH, VIRANDA [n -S]
VIRANDOS	VIRANDO, (Hindi) a roofed gallery, terrace, or open portico along the front or side of a building, also VERANDA, VERANDAH, VIRANDA [n]
VULCANISE	to change the properties of, as caoutchouc, or India rubber, by the process of vulcanization, also VULCANIZE [v VULCANISED, VULCANISING, VULCANISES]
VULCANISED	VULCANISE, to change the properties of, as caoutchouc, or India rubber, by the process of vulcanization, also VULCANIZE [v]
VULCANISES	VULCANISE, to change the properties of, as caoutchouc, or India rubber, by the process of vulcanization, also VULCANIZE [v]
VULCANISING	VULCANISE, to change the properties of, as caoutchouc, or India rubber, by the process of vulcanization, also VULCANIZE [v]
VULCANIZE	to change the properties of, as caoutchouc, or India rubber, by the process of vulcanization, also VULCANISE [v VULCANIZED, VULCANIZING, VULCANIZES]
VULCANIZED	VULCANIZE, to change the properties of, as caoutchouc, or India rubber, by the process of vulcanization, also VULCANISE [v]
VULCANIZES	VULCANIZE, to change the properties of, as caoutchouc, or India rubber, by the process of vulcanization, also VULCANISE [v]
VULCANIZING	VULCANIZE, to change the properties of, as caoutchouc, or India rubber, by the process of vulcanization, also VULCANISE [v]
WALER	in India, an Australian-bred saddle-horse [n -S]
WALERS	WALER, in India, an Australian-bred saddle-horse [n]
WALLA	(Hindi) a person employed in a specific type of work, also WALLAH [n -S]
WALLAH	(Hindi) a person who is associated with a particular work or who performs a particular duty or service - usually used in combination, also WALLA [n -S]
WALLAHS	WALLAH, (Hindi) a person who is associated with a particular work or who performs a particular duty or service - usually used in combination, also WALLA [n]
WALLAS	WALLA, (Hindi) a person employed in a specific type of work, also WALLAH [n]
WANDEROO	(Sinhalese) a long-tailed monkey, native to the Malabar coast of India [n -S]
WANDEROOS	WANDEROO, (Sinhalese) a long-tailed monkey, native to the Malabar coast of India [n]
WOOTZ	a tough sharp steel made in southern India by fusing magnetic iron ore with material containing carbon [n -ES]
WOOTZES	WOOTZ, a tough sharp steel made in southern India by fusing magnetic iron ore with material containing carbon [n]
YAAR	(Hinglish) friend, man (as a form of address) [n -S]
YAARS	YAAR, (Hinglish) friend, man (as a form of address) [n]
YANTRA	(Sanskrit) a geometrical diagram used in meditation [n -S]
YANTRAS	YANTRA, (Sanskrit) a geometrical diagram used in meditation [n]
YOGA	(Sanskrit) a system of Hindu philosophy [n -S]
YOGAS	YOGA, (Sanskrit) a system of Hindu philosophy [n]
YOGEE	(Sanskrit) one who practises yoga, also YOGI, YOGIN [n -S]
YOGEES	YOGEE, (Sanskrit) one who practises yoga, also YOGI, YOGIN [n]
YOGI	(Sanskrit) one who practises yoga, also YOGEE, YOGIN [n -S]
YOGIN	(Sanskrit) one who practises yoga, also YOGEE, YOGI [n -S]
YOGINS	YOGIN, (Sanskrit) one who practises yoga, also YOGEE, YOGI [n]
YOGIS	YOGI, (Sanskrit) one who practises yoga, also YOGEE, YOGIN [n]
YOJAN	(Hindi) in the Indian subcontinent, a measure of distance, also YOJANA [n -S]
YOJANA	(Hindi) in the Indian subcontinent, a measure of distance, also YOJAN [n -S]
YOJANAS	YOJANA, (Hindi) in the Indian subcontinent, a measure of distance, also YOJAN [n]
YOJANS	YOJAN, (Hindi) in the Indian subcontinent, a measure of distance, also YOJANA [n]
YONI	(Sanskrit) a representation of the female genitals [n -S]
YONIS	YONI, (Sanskrit) a representation of the female genitals [n]
YUG	(Sanskrit) one of the four Hindu ages of the world, also YUGA [n -S]
YUGA	(Sanskrit) one of the four Hindu ages of the world, also YUG [n -S]
YUGAS	YUGA, (Sanskrit) one of the four Hindu ages of the world, also YUG [n]
YUGS	YUG, (Sanskrit) one of the four Hindu ages of the world, also YUGA [n]
ZAMBOORAK	(Urdu) a small swivel-gun, esp. one mounted on the back of a camel, also ZOMBORUK, ZUMBOORUK [n -S]
ZAMBOORAKS	ZAMBOORAK, (Urdu) a small swivel-gun, esp. one mounted on the back of a camel, also ZOMBORUK, ZUMBOORUK [n]
ZAMINDAR	(Hindi) in India, a type of landowner, also ZEMINDAR [n -S]
ZAMINDARI	(Hindi) the jurisdiction of a zamindar, also ZAMINDARY, ZEMINDARI, ZEMINDARY [n -S]
ZAMINDARIES	ZAMINDARY, (Hindi) the jurisdiction of a zamindar, also ZAMINDARI, ZEMINDARI, ZEMINDARY [n]
ZAMINDARIS	ZAMINDARI, (Hindi) the jurisdiction of a zamindar, also ZAMINDARY, ZEMINDARI, ZEMINDARY [n]
ZAMINDARS	ZAMINDAR, (Hindi) in India, a type of landowner, also ZEMINDAR [n]
ZAMINDARY	(Hindi) the jurisdiction of a zamindar, also ZAMINDARI, ZEMINDARI, ZEMINDARY [n ZAMINDARIES]
ZANANA	(Urdu) in the Indian subcontinent, the part of a house in which high-caste women are or were secluded, also ZENANA [n -S]
ZANANAS	ZANANA, (Urdu) in the Indian subcontinent, the part of a house in which high-caste women are or were secluded, also ZENANA [n]
ZARI	(Urdu) a type of thread made of fine gold or silver wire used in traditional Indian and Pakistani garments [n -S]
ZARIS	ZARI, (Urdu) a type of thread made of fine gold or silver wire used in traditional Indian and Pakistani garments [n]
ZEIN	a protein found in Indian corn [n -S]
ZEINS	ZEIN, a protein found in Indian corn [n]
ZEMINDAR	(Hindi) in India, a type of landowner, also ZAMINDAR [n -S]
ZEMINDARI	(Hindi) the jurisdiction of a zemindar, also ZAMINDARI, ZAMINDARY, ZEMINDARY [n -S]
ZEMINDARIES	ZEMINDARY, (Hindi) the jurisdiction of a zemindar, also ZAMINDARI, ZAMINDARY, ZEMINDARI [n]
ZEMINDARIS	ZEMINDARI, (Hindi) the jurisdiction of a zemindar, also ZAMINDARI, ZAMINDARY, ZEMINDARY [n]
ZEMINDARS	ZEMINDAR, (Hindi) in India, a type of landowner, also ZAMINDAR [n]
ZEMINDARY	(Hindi) the jurisdiction of a zemindar, also ZAMINDARI, ZAMINDARY, ZEMINDARI [n ZEMINDARIES]
ZENANA	(Urdu) in the Indian subcontinent, the part of a house in which high-caste women are or were secluded, also ZANANA [n -S]
ZENANAS	ZENANA, (Urdu) in the Indian subcontinent, the part of a house in which high-caste women are or were secluded, also ZANANA [n]
ZERUMBET	(Persian) an East Indian drug, related to cassumunar and zedoary [n -S]
ZERUMBETS	ZERUMBET, (Persian) an East Indian drug, related to cassumunar and zedoary [n]
ZILA	(Hindi) an administrative district in British India, also ZILLA, ZILLAH [n -S]
ZILAS	ZILA, (Hindi) an administrative district in British India, also ZILLA, ZILLAH [n]
ZILLA	(Hindi) an administrative district in British India, also ZILA, ZILLAH [n -S]
ZILLAH	(Hindi) an administrative district in British India, also ZILA, ZILLA [n -S]
ZILLAHS	ZILLAH, (Hindi) an administrative district in British India, also ZILA, ZILLA [n]
ZILLAS	ZILLA, (Hindi) an administrative district in British India, also ZILA, ZILLAH [n]
ZINDABAD	(Hindi) long live, used in slogans [interj]
ZIZANIA	(Greek) a genus of grasses including Indian rice [n -S]
ZIZANIAS	ZIZANIA, (Greek) a genus of grasses including Indian rice [n]
ZOMBORUK	(Urdu) a small swivel-gun, esp. one mounted on the back of a camel, also ZAMBOORAK, ZUMBOORUK [n -S]
ZOMBORUKS	ZOMBORUK, (Urdu) a small swivel-gun, esp. one mounted on the back of a camel, also ZAMBOORAK, ZUMBOORUK [n]
ZUMBOORUK	(Urdu) a small swivel-gun, esp. one mounted on the back of a camel, also ZAMBOORAK, ZOMBORUK [n -S]
ZUMBOORUKS	ZUMBOORUK, (Urdu) a small swivel-gun, esp. one mounted on the back of a camel, also ZAMBOORAK, ZOMBORUK [n]